⬜⬜⬜⬜⬜⬜⬜⬜⬜⬜⬜⬜⬜⬜⬜⬜⬜⬜⬜⬜⬜⬜⬜⬜⬜⬜⬜⬜⬜⬜⬜⬜⬜⬜⬜⬜⬜⬜⬜⬜⬜⬜⬜⬜⬜⬜⬜⬜⬜⬜⬜⬜⬜⬜⬜
⬜⬛⬛⬜⬛⬜⬛⬛⬜⬛⬛⬜⬛⬛⬛⬜⬛⬛⬛⬛⬛⬜⬜⬛⬜⬛⬜⬜⬜⬜⬛⬜⬛⬛⬛⬛⬛⬜⬛⬛⬜⬛⬜⬛⬛⬛⬜⬛⬛⬛⬛⬛⬜⬛⬜
⬜⬛⬛⬜⬛⬜⬛⬜⬛⬜⬛⬛⬜⬛⬜⬛⬜⬜⬛⬛⬛⬜⬛⬜⬛⬜⬛⬛⬛⬜⬛⬜⬛⬜⬜⬜⬛⬛⬛⬛⬜⬛⬛⬜⬛⬛⬛⬜⬛⬜⬜⬛⬛⬛⬜
⬜⬛⬛⬜⬛⬜⬜⬛⬛⬜⬛⬜⬜⬜⬛⬛⬜⬛⬜⬜⬛⬛⬛⬜⬛⬜⬛⬜⬜⬛⬛⬜⬜⬛⬛⬛⬜⬛⬛⬛⬛⬜⬜⬜⬜⬛⬛⬜⬜⬛⬛⬜⬜⬛⬜
⬜⬛⬛⬜⬛⬛⬛⬜⬛⬜⬛⬛⬛⬜⬛⬜⬛⬛⬛⬜⬛⬜⬜⬛⬜⬛⬛⬜⬛⬛⬜⬛⬜⬛⬜⬛⬛⬛⬛⬜⬛⬛⬛⬛⬜⬛⬜⬛⬛⬜⬜⬛⬛⬛⬜
⬜⬜⬜⬜⬜⬛⬛⬛⬛⬜⬛⬜⬜⬛⬛⬛⬜⬜⬛⬜⬛⬜⬛⬛⬛⬛⬜⬜⬛⬜⬛⬛⬜⬛⬛⬜⬜⬜⬜⬜⬜⬜⬜⬛⬜⬛⬜⬜⬜⬛⬛⬛⬛⬛⬜
⬜⬛⬛⬛⬛⬛⬜⬜⬛⬛⬛⬛⬛⬜⬛⬛⬛⬛⬜⬛⬛⬛⬛⬛⬜⬜⬛⬜⬛⬜⬛⬜⬛⬜⬛⬜⬛⬛⬛⬛⬛⬛⬛⬛⬛⬜⬛⬜⬛⬜⬜⬛⬛⬛⬜
⬜⬛⬜⬜⬛⬛⬜⬛⬛⬛⬜⬜⬜⬛⬛⬜⬜⬛⬜⬛⬛⬜⬜⬜⬛⬛⬛⬛⬜⬛⬛⬛⬛⬜⬛⬛⬛⬜⬛⬛⬜⬜⬛⬛⬛⬛⬛⬛⬛⬛⬛⬛⬛⬜⬜
⬜⬛⬜⬛⬛⬛⬛⬜⬜⬛⬛⬛⬛⬛⬜⬛⬜⬛⬜⬛⬜⬛⬛⬛⬜⬜⬛⬛⬜⬛⬜⬜⬜⬛⬛⬛⬛⬜⬜⬜⬜⬛⬛⬛⬜⬛⬜⬛⬛⬜⬜⬜⬛⬛⬜
⬜⬛⬜⬜⬜⬛⬛⬛⬛⬛⬜⬛⬜⬛⬜⬛⬛⬛⬜⬛⬜⬛⬜⬛⬛⬛⬛⬛⬜⬛⬜⬛⬛⬜⬜⬜⬜⬛⬛⬛⬜⬛⬜⬛⬛⬜⬛⬜⬜⬛⬛⬛⬛⬛⬜
⬜⬛⬛⬛⬜⬜⬛⬜⬜⬜⬛⬜⬜⬛⬛⬜⬛⬛⬛⬛⬛⬛⬜⬛⬜⬛⬜⬛⬛⬛⬜⬛⬛⬛⬛⬛⬛⬛⬜⬜⬜⬛⬜⬛⬛⬛⬛⬛⬛⬜⬜⬜⬜⬛⬜
⬜⬛⬛⬛⬛⬛⬛⬛⬛⬛⬛⬛⬛⬛⬛⬛⬛⬛⬜⬛⬛⬛⬛⬛⬜⬛⬛⬜⬛⬜⬜⬜⬜⬜⬜⬛⬜⬛⬛⬛⬛⬛⬜⬛⬛⬛⬜⬜⬛⬜⬛⬛⬛⬛⬜
⬜⬛⬛⬜⬛⬛⬛⬜⬜⬜⬜⬜⬛⬛⬜⬜⬜⬛⬜⬛⬛⬛⬜⬛⬛⬜⬛⬜⬛⬛⬛⬛⬛⬛⬛⬛⬜⬛⬛⬜⬜⬛⬜⬛⬜⬜⬜⬛⬜⬜⬛⬛⬜⬜⬜
⬜⬛⬛⬜⬛⬛⬛⬛⬛⬛⬛⬛⬜⬛⬜⬛⬛⬛⬜⬛⬜⬜⬜⬜⬛⬜⬛⬜⬛⬜⬛⬛⬜⬜⬛⬜⬛⬜⬛⬜⬛⬜⬛⬜⬛⬛⬛⬜⬛⬛⬜⬜⬛⬛⬜
⬜⬛⬛⬛⬜⬜⬜⬛⬜⬜⬛⬜⬜⬛⬜⬛⬜⬛⬛⬜⬛⬛⬛⬛⬜⬛⬜⬜⬛⬜⬛⬛⬛⬛⬛⬜⬛⬜⬛⬛⬛⬛⬛⬜⬜⬜⬛⬛⬜⬜⬛⬛⬜⬜⬜
⬜⬜⬜⬛⬛⬛⬛⬛⬛⬜⬛⬛⬛⬛⬜⬛⬜⬛⬜⬜⬛⬜⬜⬛⬜⬛⬛⬛⬛⬛⬛⬛⬜⬜⬜⬜⬛⬛⬛⬛⬛⬜⬜⬛⬛⬜⬛⬛⬛⬛⬛⬛⬜⬛⬜
⬜⬛⬜⬛⬛⬜⬜⬛⬜⬛⬛⬜⬜⬛⬜⬛⬛⬛⬛⬛⬛⬛⬛⬜⬛⬛⬜⬜⬜⬛⬛⬛⬛⬛⬛⬜⬛⬛⬛⬛⬛⬛⬜⬛⬜⬛⬛⬛⬛⬛⬛⬛⬛⬛⬜
⬜⬜⬜⬛⬜⬛⬛⬜⬛⬜⬜⬛⬛⬛⬜⬛⬛⬛⬜⬜⬜⬜⬜⬛⬛⬛⬛⬛⬛⬜⬛⬛⬜⬛⬛⬛⬜⬜⬛⬛⬛⬛⬜⬛⬛⬛⬛⬛⬛⬛⬛⬛⬛⬛⬜
⬜⬛⬜⬛⬜⬛⬜⬛⬛⬛⬛⬜⬜⬛⬜⬛⬛⬜⬛⬛⬜⬛⬛⬛⬛⬜⬛⬜⬛⬜⬛⬜⬛⬜⬜⬛⬜⬛⬜⬛⬜⬜⬛⬜⬛⬜⬜⬛⬛⬛⬜⬜⬛⬛⬜
⬜⬛⬛⬛⬜⬛⬜⬛⬛⬛⬛⬛⬛⬜⬛⬜⬛⬛⬛⬛⬛⬛⬛⬛⬛⬛⬜⬛⬛⬛⬛⬜⬛⬛⬛⬛⬜⬜⬜⬜⬜⬛⬛⬜⬜⬛⬛⬜⬜⬛⬜⬛⬛⬛⬜
⬜⬛⬛⬛⬜⬛⬛⬛⬛⬛⬛⬛⬜⬛⬛⬛⬜⬜⬜⬛⬜⬜⬜⬜⬜⬛⬜⬛⬜⬜⬛⬛⬛⬛⬜⬛⬛⬛⬛⬛⬛⬜⬜⬛⬛⬜⬜⬜⬛⬛⬛⬛⬛⬛⬜
⬜⬛⬜⬛⬛⬜⬜⬜⬜⬛⬜⬜⬛⬜⬜⬛⬛⬛⬜⬛⬛⬛⬛⬛⬛⬜⬛⬜⬛⬜⬛⬜⬜⬜⬛⬜⬜⬜⬜⬜⬜⬜⬛⬛⬛⬛⬛⬛⬛⬜⬜⬜⬛⬛⬜
⬜⬜⬜⬛⬜⬛⬛⬛⬛⬜⬛⬜⬛⬛⬛⬜⬜⬛⬜⬛⬜⬜⬛⬜⬛⬛⬛⬜⬛⬛⬛⬛⬛⭐⬛⬛⬛⬛⬛⬜⬛⬛⬛⬛⬛⬛⬜⬛⬛⬛⬛⬛⬜⬜⬜
⬜⬜⬛⬛⬜⬜⬛⬜⬜⬛⬜⬛⬛⬜⬛⬜⬛⬛⬜⬛⬛⬛⬛⬜⬜⬛⬜⬛⬛⬜⬜⬜⬜⬜⬜⬛⬛⬜⬜⬛⬛⬛⬛⬛⬛⬜⬛⬜⬛⬜⬜⬛⬛⬛⬜
⬜⬛⬛⬛⬛⬜⬛⬛⬜⬛⬜⬛⬜⬜⬛⬛⬜⬜⬛⬜⬜⬜⬛⬛⬛⬛⬜⬛⬜⬛⬛⬛⬛⬜⬛⬜⬜⬛⬜⬜⬛⬛⬛⬛⬛⬜⬛⬜⬛⬜⬛⬛⬜⬜⬜
⬜⬛⬛⬛⬛⬜⬜⬛⬜⬛⬜⬛⬜⬛⬜⬛⬛⬛⬛⬛⬛⬛⬛⬛⬛⬜⬜⬛⬜⬛⬜⬛⬛⬜⬛⬜⬛⬛⬜⬛⬛⬜⬜⬜⬛⬜⬛⬜⬛⬛⬜⬛⬛⬜⬜
⬜⬛⬛⬛⬜⬛⬛⬛⬜⬛⬜⬛⬛⬛⬜⬛⬜⬜⬜⬜⬜⬜⬜⬜⬛⬛⬜⬛⬜⬛⬛⬜⬛⬜⬛⬛⬜⬛⬜⬛⬛⬛⬛⬛⬛⬛⬜⬛⬛⬜⬜⬛⬛⬜⬜
⬜⬛⬛⬛⬜⬛⬜⬜⬜⬛⬛⬛⬜⬛⬜⬜⬛⬛⬛⬛⬛⬛⬛⬜⬛⬜⬜⬛⬜⬛⬜⬜⬛⬛⬜⬛⬜⬛⬜⬛⬜⬛⬛⬛⬛⬛⬜⬛⬛⬛⬛⬜⬛⬜⬜
⬜⬛⬜⬛⬜⬛⬛⬛⬜⬛⬜⬜⬛⬜⬛⬛⬛⬜⬛⬜⬛⬜⬛⬜⬛⬛⬛⬛⬜⬜⬛⬜⬛⬜⬛⬛⬜⬛⬜⬛⬜⬛⬛⬛⬛⬛⬛⬜⬜⬛⬜⬛⬜⬛⬜
⬜⬛⬜⬛⬛⬛⬛⬛⬛⬛⬜⬛⬛⬛⬛⬜⬛⬜⬛⬜⬛⬛⬜⬜⬛⬛⬛⬜⬛⬜⬛⬜⬛⬛⬜⬜⬛⬛⬜⬜⬛⬜⬜⬛⬜⬜⬜⬜⬛⬜⬛⬛⬛⬛⬜
⬜⬛⬜⬛⬜⬛⬛⬛⬛⬛⬜⬛⬜⬛⬜⬜⬛⬜⬛⬜⬛⬛⬛⬛⬜⬛⬜⬛⬛⬛⬜⬜⬛⬛⬛⬛⬜⬜⬛⬜⬛⬛⬛⬛⬛⬛⬛⬛⬛⬜⬛⬜⬛⬜⬜
⬜⬛⬜⬛⬜⬜⬛⬛⬜⬛⬛⬜⬛⬜⬜⬛⬛⬜⬛⬜⬛⬜⬛⬛⬜⬛⬛⬜⬛⬛⬛⬛⬜⬛⬜⬜⬜⬛⬛⬛⬜⬜⬜⬛⬜⬛⬜⬜⬜⬛⬛⬜⬛⬜⬜
⬜⬛⬛⬜⬛⬛⬛⬛⬛⬜⬛⬛⬜⬛⬛⬛⬜⬜⬛⬛⬜⬜⬜⬜⬛⬛⬛⬜⬛⬜⬜⬜⬛⬜⬛⬜⬛⬛⬛⬛⬛⬛⬜⬛⬜⬛⬛⬛⬛⬜⬜⬛⬛⬛⬜
⬜⬛⬜⬛⬛⬛⬛⬜⬛⬛⬜⬛⬛⬜⬛⬛⬛⬛⬜⬛⬛⬛⬛⬛⬛⬜⬛⬜⬛⬛⬛⬜⬛⬛⬛⬛⬛⬛⬛⬜⬛⬛⬜⬜⬛⬜⬛⬜⬛⬛⬛⬛⬛⬜⬜
⬜⬜⬛⬜⬛⬜⬛⬛⬜⬛⬜⬛⬜⬜⬜⬜⬛⬜⬜⬛⬛⬛⬜⬜⬜⬛⬛⬛⬛⬜⬛⬜⬛⬜⬛⬛⬛⬜⬛⬜⬛⬜⬛⬛⬛⬜⬛⬜⬛⬛⬜⬛⬜⬛⬜
⬜⬜⬛⬛⬛⬜⬛⬜⬛⬛⬜⬛⬛⬛⬛⬛⬛⬜⬛⬜⬛⬛⬛⬛⬛⬛⬜⬜⬛⬜⬛⬜⬛⬛⬜⬜⬜⬛⬜⬜⬛⬜⬛⬛⬛⬜⬜⬛⬜⬜⬜⬛⬜⬛⬜
⬜⬜⬜⬜⬜⬜⬛⬜⬜⬜⬛⬜⬛⬛⬜⬜⬛⬛⬛⬛⬛⬛⬜⬜⬛⬛⬛⬛⬜⬛⬜⬜⬛⬛⬜⬛⬛⬛⬛⬛⬛⬛⬜⬛⬜⬛⬛⬛⬛⬜⬛⬛⬜⬛⬜
⬜⬛⬛⬛⬛⬜⬛⬛⬛⬛⬛⬛⬜⬜⬛⬜⬜⬜⬛⬛⬛⬜⬛⬜⬜⬜⬜⬜⬛⬛⬜⬛⬜⬛⬛⬜⬜⬜⬜⬜⬜⬜⬛⬜⬜⬛⬜⬛⬛⬛⬛⬛⬛⬜⬜
⬜⬜⬜⬜⬜⬛⬜⬜⬜⬜⬜⬛⬛⬛⬛⬛⬛⬛⬛⬛⬛⬜⬛⬛⬛⬛⬛⬛⬜⬛⬜⬛⬜⬛⬛⬛⬛⬛⬛⬛⬛⬜⬛⬛⬛⬛⬜⬛⬛⬛⬜⬜⬜⬛⬜
⬜⬛⬛⬜⬛⬛⬜⬛⬛⬛⬛⬜⬜⬛⬜⬜⬜⬜⬛⬛⬛⬜⬛⬜⬜⬛⬜⬛⬜⬛⬜⬛⬜⬛⬛⬛⬜⬜⬜⬛⬛⬜⬜⬜⬜⬜⬜⬛⬜⬜⬛⬛⬛⬜⬜
⬜⬜⬛⬛⬛⬜⬛⬜⬛⬜⬛⬜⬛⬜⬛⬛⬛⬛⬛⬛⬛⬛⬛⬛⬛⬛⬜⬛⬛⬜⬛⬛⬜⬜⬛⬛⬛⬛⬛⬛⬜⬛⬛⬛⬜⬛⬛⬛⬛⬜⬛⬜⬛⬛⬜
⬜⬜⬛⬜⬜⬛⬛⬛⬜⬛⬜⬛⬛⬛⬜⬜⬛⬛⬛⬜⬛⬜⬜⬜⬜⬜⬛⬜⬛⬛⬛⬜⬛⬛⬜⬛⬜⬜⬜⬜⬛⬛⬛⬜⬛⬛⬛⬛⬛⬜⬛⬜⬛⬛⬜
⬜⬜⬛⬜⬛⬛⬜⬛⬜⬛⬜⬜⬜⬛⬛⬛⬜⬜⬜⬛⬜⬛⬛⬛⬛⬛⬜⬜⬛⬜⬛⬛⬛⬛⬜⬛⬛⬛⬛⬛⬛⬜⬛⬜⬛⬛⬛⬛⬜⬛⬛⬛⬜⬛⬜
⬜⬛⬛⬜⬛⬜⬛⬛⬜⬛⬛⬛⬜⬜⬜⬛⬛⬛⬛⬜⬛⬜⬛⬜⬜⬛⬜⬛⬛⬜⬛⬛⬛⬛⬛⬛⬛⬜⬛⬛⬛⬜⬛⬜⬛⬜⬛⬜⬛⬜⬜⬛⬜⬜⬜
⬜⬜⬜⬜⬛⬛⬜⬜⬛⬛⬛⬜⬛⬛⬛⬛⬜⬜⬛⬛⬛⬜⬛⬜⬛⬛⬜⬛⬜⬜⬛⬛⬛⬛⬜⬛⬜⬛⬜⬜⬜⬛⬜⬜⬛⬜⬛⬜⬛⬜⬛⬛⬛⬜⬜
⬜⬛⬛⬛⬛⬜⬛⬜⬛⬜⬛⬛⬛⬜⬜⬛⬛⬛⬜⬛⬜⬛⬛⬜⬛⬜⬛⬛⬛⬜⬛⬛⬛⬜⬛⬜⬜⬜⬛⬛⬜⬛⬛⬛⬛⬜⬛⬛⬛⬜⬛⬜⬜⬛⬜
⬜⬛⬜⬜⬛⬛⬛⬛⬛⬜⬛⬜⬜⬛⬛⬜⬛⬜⬛⬜⬛⬛⬜⬛⬜⬛⬛⬛⬛⬜⬛⬛⬛⬛⬛⬛⬛⬛⬛⬛⬜⬛⬜⬛⬜⬛⬜⬜⬛⬜⬛⬛⬛⬜⬜
⬜⬛⬛⬛⬜⬛⬜⬜⬜⬛⬜⬛⬛⬛⬛⬜⬛⬜⬛⬜⬜⬜⬜⬛⬛⬜⬛⬜⬛⬜⬛⬛⬛⬜⬜⬜⬜⬜⬜⬛⬛⬛⬜⬛⬜⬛⬜⬛⬛⬜⬜⬜⬛⬜⬜
⬜⬜⬜⬛⬛⬜⬛⬜⬜⬛⬜⬛⬜⬜⬛⬜⬛⬜⬛⬜⬛⬛⬛⬛⬛⬛⬜⬛⬛⬜⬛⬛⬛⬛⬛⬛⬛⬛⬛⬛⬛⬜⬛⬛⬜⬛⬛⬛⬜⬛⬛⬛⬛⬜⬜
⬜⬛⬜⬛⬜⬜⬛⬛⬛⬜⬜⬛⬜⬜⬛⬜⬛⬛⬛⬜⬜⬛⬛⬛⬛⬛⬜⬜⬛⬜⬛⬜⬜⬛⬜⬛⬜⬜⬛⬛⬜⬛⬜⬜⬛⬜⬜⬛⬜⬜⬛⬜⬜⬜⬜
⬜⬛⬛⬜⬛⬛⬛⬛⬛⬛⬛⬛⬜⬛⬛⬛⬛⬜⬛⬜⬛⬛⬛⬛⬛⬛⬜⬛⬛⬜⬛⬜⬛⬛⬜⬛⬜⬛⬜⬛⬜⬜⬛⬛⬛⬛⬛⬛⬛⬛⬛⬛⬛⬛⬜
⬜⬛⬜⬜⬛⬜⬜⬜⬜⬜⬛⬛⬜⬜⬜⬛⬜⬜⬛⬛⬜⬛⬜⬛⬛⬛⬜⬛⬛⬜⬛⬜⬛⬛⬛⬛⬛⬛⬜⬛⬛⬛⬜⬜⬜⬛⬜⬜⬜⬛⬛⬛⬛⬛⬜
⬜⬛⬛⬜⬜⬜⬛⬛⬛⬛⬛⬛⬛⬛⬛⬛⬛⬛⬜⬛⬛⬜⬜⬛⬛⬛⬜⬜⬜⬜⬛⬜⬛⬛⬛*️⃣⬛⬛⬜⬛⬜⬜⬛⬛⬛⬛⬛⬛⬜⬛⬛⬛⬛⬛⬜
⬜⬜⬜⬛⬛⬛⬜⬜⬜⬜⬜⬜⬛⬜⬜⬜⬜⬜⬜⬛⬛⬛⬛⬛⬜⬛⬜⬛⬛⬛⬛⬛⬜⬛⬛⬛⬛⬛⬜⬛⬜⬛⬛⬛⬛⬜⬜⬜⬛⬜⬜⬛⬛⬛⬜
⬜⬜⬜⬜⬜⬜⬜⬜⬜⬜⬜⬜⬜⬜⬜⬜⬜⬜⬜⬜⬜⬜⬜⬜⬜⬜⬜⬜⬜⬜⬜⬜⬜⬜⬜⬜⬜⬜⬜⬜⬜⬜⬜⬜⬜⬜⬜⬜⬜⬜⬜⬜⬜⬜⬜
