⬜⬜⬜⬜⬜⬜⬜⬜⬜⬜⬜⬜⬜⬜⬜⬜⬜⬜⬜⬜⬜⬜⬜⬜⬜⬜⬜⬜⬜⬜⬜⬜⬜⬜⬜⬜⬜⬜⬜⬜⬜⬜⬜⬜⬜⬜⬜⬜⬜⬜⬜⬜⬜⬜⬜
⬜⬛⬛⬜⬜⬛⬛⬜⬛⬛⬜⬛⬛⬛⬛⬛⬛⬜⬛⬛⬜⬜⬛⬛⬜⬛⬜⬛⬜⬛⬛⬜⬛⬛⬜⬛⬜⬜⬛⬜⬛⬜⬜⬜⬛⬜⬜⬛⬜⬛⬜⬛⬛⬛⬜
⬜⬜⬜⬛⬛⬛⬛⬛⬜⬛⬜⬜⬛⬛⬜⬛⬜⬛⬛⬜⬜⬛⬛⬜⬛⬛⬜⬛⬜⬛⬜⬛⬛⬛⬛⬛⬛⬜⬛⬜⬛⬜⬛⬛⬜⬜⬜⬛⬜⬛⬜⬛⬛⬜⬜
⬜⬛⬜⬛⬜⬛⬛⬛⬛⬜⬛⬛⬜⬛⬜⬛⬛⬜⬛⬛⬛⬜⬛⬜⬜⬜⬛⬛⬜⬛⬜⬛⬛⬛⬛⬜⬜⬛⬜⬜⬛⬛⬛⬛⬛⬛⬛⬛⬜⬛⬛⬛⬛⭐⬜
⬜⬜⬛⬛⬜⬜⬛⬛⬜⬜⬛⬜⬛⬛⬛⬜⬛⬜⬜⬜⬜⬛⬛⬛⬜⬛⬜⬜⬛⬛⬛⬜⬜⬛⬛⬛⬛⬛⬜⬛⬜⬛⬛⬛⬜⬛⬜⬜⬛⬜⬜⬛⬛⬜⬜
⬜⬜⬛⬛⬛⬛⬛⬛⬛⬛⬛⬜⬛⬛⬛⬜⬛⬛⬛⬛⬜⬛⬜⬛⬛⬛⬜⬛⬜⬜⬜⬛⬛⬛⬜⬛⬛⬜⬛⬛⬜⬛⬜⬜⬜⬛⬛⬜⬛⬛⬛⬜⬛⬜⬜
⬜⬛⬜⬛⬜⬜⬛⬛⬜⬜⬜⬛⬛⬛⬜⬛⬛⬜⬜⬛⬛⬛⬜⬛⬜⬛⬜⬛⬜⬛⬛⬜⬛⬜⬛⬜⬛⬜⬛⬛⬜⬜⬜⬛⬛⬜⬛⬛⬛⬜⬛⬜⬛⬜⬜
⬜⬛⬜⬜⬛⬛⬛⬜⬛⬜⬛⬛⬛⬜⬜⬜⬜⬛⬜⬛⬛⬛⬛⬛⬜⬛⬛⬛⬜⬛⬛⬜⬛⬜⬛⬛⬛⬜⬛⬜⬛⬛⬛⬛⬜⬜⬛⬛⬛⬜⬛⬜⬛⬛⬜
⬜⬜⬛⬛⬜⬛⬛⬜⬛⬜⬛⬛⬛⬛⬜⬛⬛⬛⬜⬜⬜⬜⬜⬛⬜⬛⬛⬛⬜⬜⬛⬛⬛⬜⬜⬜⬜⬛⬛⬜⬛⬛⬜⬜⬛⬜⬛⬜⬛⬜⬛⬛⬛⬛⬜
⬜⬛⬜⬜⬛⬛⬛⬛⬛⬜⬛⬛⬛⬜⬛⬛⬜⬜⬛⬛⬛⬜⬛⬜⬛⬜⬜⬜⬛⬛⬛⬜⬛⬛⬛⬛⬛⬛⬛⬜⬛⬜⬛⬛⬜⬛⬜⬜⬜⬛⬜⬜⬛⬛⬜
⬜⬛⬛⬛⬛⬜⬛⬛⬜⬛⬛⬛⬜⬛⬛⬛⬛⬛⬛⬜⬛⬜⬛⬛⬛⬛⬛⬛⬛⬛⬛⬜⬛⬛⬛⬜⬛⬜⬛⬜⬜⬜⬛⬜⬛⬛⬜⬛⬛⬛⬜⬛⬜⬛⬜
⬜⬛⬜⬜⬛⬜⬜⬛⬛⬛⬜⬛⬜⬜⬛⬛⬜⬜⬜⬜⬜⬜⬛⬛⬜⬛⬜⬛⬛⬜⬛⬜⬛⬜⬛⬛⬜⬜⬜⬛⬛⬛⬜⬜⬛⬜⬜⬛⬛⬛⬜⬛⬜⬜⬜
⬜⬛⬜⬛⬛⬛⬛⬛⬛⬛⬜⬛⬛⬛⬛⬛⬛⬛⬛⬛⬛⬛⬛⬜⬛⬛⬜⬛⬛⬜⬜⬛⬜⬜⬛⬛⬛⬛⬛⬛⬛⬛⬛⬛⬜⬛⬛⬜⬜⬛⬜⬛⬛⬜⬜
⬜⬜⬜⬛⬜⬛⬜⬛⬜⬛⬛⬜⬛⬛⬜⬜⬜⬜⬛⬛⬛⬛⬛⬜⬛⬛⬜⬛⬛⬛⬜⬛⬛⬜⬜⬜⬜⬜⬛⬛⬛⬜⬛⬛⬛⬛⬛⬜⬛⬛⬜⬛⬜⬛⬜
⬜⬛⬛⬛⬜⬛⬜⬜⬛⬜⬛⬜⬛⬜⬜⬜⬛⬛⬛⬜⬛⬛⬛⬜⬜⬛⬜⬛⬜⬛⬜⬜⬛⬛⬛⬛⬛⬛⬛⬜⬛⬜⬛⬜⬛⬜⬛⬛⬛⬜⬛⬛⬜⬛⬜
⬜⬛⬜⬛⬜⬛⬛⬛⬜⬜⬛⬜⬛⬛⬛⬛⬛⬜⬛⬜⬛⬛⬛⬛⬛⬛⬜⬛⬜⬜⬛⬜⬛⬛⬛⬜⬜⬛⬜⬜⬛⬜⬛⬜⬛⬜⬛⬜⬛⬛⬜⬛⬛⬛⬜
⬜⬛⬜⬛⬜⬛⬜⬛⬛⬛⬛⬛⬛⬛⬜⬜⬜⬛⬜⬛⬛⬜⬛⬜⬜⬛⬜⬛⬛⬛⬛⬛⬛⬛⬛⬜⬛⬛⬜⬛⬛⬛⬛⬜⬛⬜⬛⬜⬜⬜⬛⬜⬜⬜⬜
⬜⬛⬜⬛⬜⬛⬜⬛⬛⬛⬛⬜⬜⬛⬜⬛⬛⬛⬜⬛⬜⬜⬛⬜⬛⬛⬜⬛⬛⬜⬜⬛⬛⬛⬜⬛⬜⬛⬛⬛⬛⬛⬛⬜⬛⬜⬜⬛⬛⬛⬜⬛⬛⬛⬜
⬜⬛⬜⬛⬜⬛⬜⬛⬛⬛⬛⬛⬛⬛⬛⬛⬜⬛⬜⬛⬜⬛⬜⬛⬛⬛⬛⬛⬛⬛⬛⬛⬛⬛⬜⬛⬜⬜⬛⬜⬛⬛⬜⬛⬜⬛⬛⬜⬜⬛⬜⬜⬛⬛⬜
⬜⬛⬜⬛⬜⬛⬛⬜⬜⬜⬛⬜⬛⬜⬛⬜⬛⬛⬛⬛⬜⬜⬛⬛⬛⬛⬜⬜⬛⬜⬛⬛⬜⬜⬜⬛⬜⬛⬜⬜⬜⬛⬜⬛⬛⬛⬛⬛⬜⬛⬜⬛⬜⬜⬜
⬜⬛⬛⬛⬜⬜⬜⬛⬛⬜⬛⬜⬛⬜⬜⬛⬜⬜⬛⬛⬛⬛⬛⬛⬛⬛⬜⬛⬛⬜⬛⬛⬛⬛⬛⬛⬜⬛⬛⬛⬛⬛⬛⬜⬜⬜⬛⬛⬜⬛⬜⬜⬛⬛⬜
⬜⬛⬜⬛⬛⬛⬛⬜⬜⬛⬜⬛⬛⬛⬛⬛⬛⬛⬜⬜⬛⬛⬛⬛⬜⬛⬜⬛⬜⬛⬛⬛⬛⬜⬜⬛⬛⬜⬛⬛⬛⬛⬛⬜⬛⬛⬜⬛⬜⬛⬛⬛⬜⬛⬜
⬜⬜⬛⬛⬛⬛⬜⬛⬛⬛⬛⬜⬜⬜⬛⬛⬛⬛⬛⬛⬛⬛⬛⬛⬜⬛⬜⬛⬛⬜⬛⬛⬛⬛⬛⬜⬛⬜⬛⬛⬛⬛⬛⬛⬛⬛⬜⬛⬜⬛⬜⬛⬛⬛⬜
⬜⬛⬜⬛⬛⬛⬜⬜⬜⬜⬛⬛⬛⬜⬜⬛⬜⬜⬜⬜⬜⬜⬜⬛⬜⬛⬛⬛⬛⬜⬛⬛⬜⬜⬜⬛⬜⬛⬜⬜⬜⬛⬛⬛⬛⬜⬛⬜⬜⬜⬛⬛⬛⬜⬜
⬜⬛⬜⬜⬜⬛⬛⬛⬛⬛⬛⬜⬜⬛⬛⬛⬛⬛⬛⬛⬜⬛⬛⬜⬛⬜⬜⬜⬛⬜⬜⬛⬛⬛⬛⬛⬜⬛⬜⬛⬛⬜⬛⬛⬛⬛⬛⬛⬛⬛⬛⬛⬛⬛⬜
⬜⬜⬛⬛⬜⬜⬜⬛⬜⬛⬛⬛⬜⬛⬜⬜⬛⬜⬜⬛⬛⬛⬜⬛⬜⬛⬛⬜⬜⬛⬛⬛⬛⬜⬛⬛⬜⬛⬛⬜⬛⬛⬛⬛⬛⬜⬛⬛⬛⬛⬛⬜⬜⬛⬜
⬜⬜⬛⬜⬛⬛⬛⬜⬛⬜⬛⬜⬛⬜⬛⬛⬛⬛⬜⬛⬜⬛⬜⬛⬜⬛⬛⬛⬛⬜⬜⬛⬜⬜⬜⬜⬛⬛⬜⬛⬛⬛⬜⬛⬜⬜⬜⬜⬜⬛⬛⬛⬜⬜⬜
⬜⬛⬜⬜⬛⬛⬛⬛⬜⬛⬛⬛⬛⬜⬛⬜⬜⬛⬜⬛⬜⬜⬜⬛⬛⬛⬛⬛⬛⬛⬜⬛⬜⬛⬛⬛⬜⬛⬜⬜⬛⬛⬜⬛⬜⬛⬛⬛⬛⬛⬜⬜⬛⬛⬜
⬜⬛⬜⬛⬛⬜⬜⬛⬜⬛⬛⬜⬛⬛⬛⬛⬜⬛⬛⬛⬛⬛⬛⬜⬛⬜⬛⬛⬛⬜⬛⬛⬜⬜⬛⬛⬜⬛⬛⬛⬜⬛⬛⬜⬜⬛⬜⬜⬛⬜⬛⬜⬛⬛⬜
⬜⬛⬜⬜⬛⬛⬜⬛⬜⬛⬛⬜⬜⬜⬜⬜⬛⬜⬜⬜⬜⬜⬛⬛⬜⬛⬜⬛⬛⬜⬜⬛⬛⬛⬜⬛⬛⬜⬛⬜⬛⬛⬛⬛⬛⬛⬛⬜⬛⬜⬛⬜⬛⬜⬜
⬜⬛⬛⬛⬜⬜⬜⬛⬛⬛⬜⬛⬛⬛⬜⬛⬛⬛⬜⬛⬛⬛⬛⬜⬜⬛⬜⬛⬛⬛⬛⬜⬛⬛⬜⬛⬜⬜⬛⬛⬛⬛⬛⬜⬜⬛⬜⬛⬛⬛⬛⬜⬜⬛⬜
⬜⬛⬜⬛⬛⬛⬛⬛⬜⬛⬜⬛⬜⬜⬛⬛⬛⬛⬜⬛⬜⬜⬛⬜⬛⬛⬜⬜⬜⬜⬜⬜⬛⬜⬛⬛⬛⬛⬜⬛⬛⬛⬛⬛⬜⬛⬜⬛⬛⬜⬛⬛⬜⬛⬜
⬜⬛⬜⬛⬜⬜⬛⬜⬛⬛⬛⬛⬛⬛⬛⬛⬛⬜⬛⬜⬛⬜⬛⬛⬛⬛⬛⬛⬛⬛⬛⬛⬛⬜⬜⬜⬜⬜⬛⬛⬛⬛⬛⬛⬜⬛⬜⬛⬜⬜⬜⬜⬛⬜⬜
⬜⬜⬛⬛⬜⬛⬛⬜⬜⬜⬜⬛⬜⬜⬛⬛⬜⬛⬛⬜⬜⬛⬛⬛⬛⬛⬛⬜⬜⬜⬜⬜⬜⬛⬛⬛⬛⬛⬛⬛⬛⬛⬛⬛⬛⬛⬛⬛⬛⬜⬛⬛⬜⬜⬜
⬜⬜⬜⬜⬛⬜⬜⬛⬛⬛⬛⬜⬛⬜⬛⬛⬛⬛⬜⬛⬜⬛⬛⬛⬛⬛⬛⬛⬜⬛⬛⬛⬛⬜⬜⬜⬛⬛⬛⬛⬜⬛⬛⬜⬛⬛⬛⬛⬛⬛⬛⬛⬜⬛⬜
⬜⬛⬛⬛⬛⬛⬛⬛⬜⬜⬛⬜⬛⬜⬛⬜⬛⬛⬜⬛⬜⬛⬛⬜⬛⬛⬛⬛⬛⬜⬛⬛⬛⬜⬛⬛⬛⬛⬛⬛⬜⬛⬜⬛⬜⬛⬜⬛⬛⬛⬛⬛⬛⬛⬜
⬜⬛⬛⬛⬛⬛⬛⬛⬜⬛⬛⬜⬛⬜⬜⬛⬜⬛⬜⬛⬜⬜⬜⬛⬛⬛⬛⬛⬜⬜⬛⬛⬛⬜⬛⬜⬜⬛⬜⬜⬛⬛⬛⬛⬛⬛⬜⬛⬛⬛⬛⬛⬛⬛⬜
⬜⬜⬜⬛⬜⬛⬛⬛⬛⬛⬛⬛⬛⬛⬜⬛⬜⬛⬛⬛⬛⬛⬛⬛⬜⬜⬜⬜⬛⬛⬜⬜⬜⬜⬜⬛⬜⬜⬛⬛⬛⬛⬛⬛⬛⬜⬛⬛⬛⬜⬜⬛⬛⬛⬜
⬜⬛⬜⬜⬜⬛⬛⬜⬜⬛⬜⬛⬜⬛⬜⬛⬛⬜⬛⬜⬜⬛⬛⬜⬛⬛⬜⬛⬛⬜⬛⬛⬛⬛⬜⬛⬛⬛⬛⬛⬛⬛⬛⬛⬜⬛⬛⬜⬛⬜⬛⬜⬛⬛⬜
⬜⬜⬛⬛⬛⬛⬛⬜⬛⬛⬜⬛⬜⬛⬛⬛⬜⬛⬛⬜⬛⬜⬛⬜⬛⬛⬜⬛⬜⬛⬜⬛⬛⬜⬛⬛⬛⬛⬛⬛⬜⬜⬛⬜⬛⬛⬛⬜⬛⬜⬜⬜⬛⬛⬜
⬜⬛⬜⬜⬜⬛⬛⬛⬜⬛⬜⬛⬜⬜⬛⬜⬛⬛⬜⬜⬛⬛⬛⬜⬜⬜⬛⬛⬜⬛⬜⬛⬛⬜⬛⬛⬛⬛⬛⬛⬜⬜⬛⬜⬛⬜⬜⬜⬛⬛⬛⬛⬜⬜⬜
⬜⬛⬛⬜⬛⬜⬛⬜⬛⬛⬜⬛⬛⬛⬛⬜⬛⬜⬛⬜⬜⬛⬜⬛⬛⬛⬜⬛⬜⬛⬜⬛⬛⬛⬛⬛⬛⬛⬛⬛⬛⬛⬛⬜⬜⬛⬛⬜⬛⬜⬜⬛⬛⬛⬜
⬜⬛⬜⬛⬛⬜⬛⬜⬛⬜⬛⬛⬛⬜⬜⬜⬛⬜⬛⬛⬜⬛⬜⬛⬜⬛⬜⬛⬛⬛⬜⬛⬛⬛⬜⬜⬜⬜⬛⬛⬛⬜⬜⬛⬛⬜⬛⬜⬛⬛⬛⬜⬜⬜⬜
⬜⬛⬜⬜⬜⬛⬛⬜⬛⬜⬜⬜⬜⬛⬜⬛⬛⬛⬜⬛⬛⬛⬜⬛⬜⬛⬜⬜⬛⬛⬜⬛⬛⬛⬜⬛⬛⬜⬛⬛⬛⬛⬜⬛⬜⬜⬛⬛⬜⬛⬛⬛⬛⬛⬜
⬜⬛⬛⬜⬛⬛⬛⬛⬛⬜⬛⬛⬛⬛⬛⬛⬜⬛⬜⬛⬛⬜⬜⬛⬜⬛⬜⬛⬜⬛⬜⬛⬛⬛⬜⬛⬛⬜⬜⬛⬜⬜⬜⬛⬜⬛⬜⬛⬜⬜⬜⬜⬛⬛⬜
⬜⬜⬛⬛⬛⬛⬛⬛⬛⬛⬛⬜⬜⬜⬜⬜⬛⬛⬜⬛⬜⬜⬛⬛⬜⬛⬜⬛⬜⬛⬛⬛⬛⬛⬜⬛⬜⬛⬜⬛⬜⬛⬛⬜⬛⬛⬜⬜⬛⬛⬜⬛⬜⬛⬜
⬜⬛⬜⬛⬛⬛⬜⬛⬜⬜⬛⬜⬛⬛⬛⬛⬜⬜⬛⬜⬛⬜⬛⬜⬜⬛⬜⬛⬛⬜⬜⬜⬛⬜⬜⬜⬛⬛⬜⬛⬜⬛⬛⬜⬛⬜⬛⬛⬛⬜⬛⬛⬛⬜⬜
⬜⬛⬜⬛⬛⬜⬜⬛⬜⬜⬛⬜⬛⬜⬛⬛⬛⬛⬛⬛⬜⬛⬛⬛⬛⬛⬜⬛⬛⬜⬛⬜⬜⬛⬛⬛⬛⬛⬜⬛⬜⬛⬛⬜⬛⬜⬜⬛⬛⬛⬛⬛⬜⬜⬜
⬜⬜⬛⬛⬜⬛⬛⬛⬜⬛⬛⬜⬛⬜⬜⬜⬜⬛⬜⬛⬜⬛⬜⬜⬜⬜⬜⬜⬜⬛⬛⬛⬛⬜⬜⬜⬜⬛⬛⬛⬛⬛⬜⬛⬛⬜⬛⬜⬜⬛⬛⬜⬜⬛⬜
⬜⬛⬛⬛⬛⬜⬛⬛⬜⬛⬛⬜⬛⬛⬛⬛⬛⬜⬛⬜⬜⬛⬛⬛⬛⬛⬛⬛⬜⬛*️⃣⬛⬛⬛⬜⬛⬜⬜⬜⬜⬜⬛⬛⬜⬜⬛⬛⬜⬛⬜⬛⬛⬛⬜⬜
⬜⬛⬛⬜⬛⬜⬛⬜⬜⬜⬛⬛⬜⬜⬛⬜⬛⬛⬛⬛⬜⬛⬜⬜⬜⬛⬜⬛⬜⬛⬛⬛⬛⬛⬛⬜⬛⬛⬛⬜⬛⬜⬜⬛⬛⬛⬜⬛⬜⬜⬛⬜⬜⬛⬜
⬜⬛⬛⬛⬜⬛⬛⬛⬛⬜⬜⬜⬜⬛⬜⬛⬛⬛⬛⬛⬛⬜⬛⬛⬜⬛⬜⬛⬜⬜⬛⬛⬜⬛⬛⬛⬛⬜⬜⬛⬛⬛⬛⬛⬜⬛⬜⬛⬜⬛⬜⬛⬛⬛⬜
⬜⬛⬜⬛⬜⬛⬛⬛⬜⬛⬛⬛⬛⬛⬜⬛⬜⬜⬛⬛⬛⬛⬛⬜⬛⬛⬛⬛⬛⬛⬜⬜⬛⬛⬛⬛⬛⬛⬛⬜⬜⬜⬜⬛⬜⬛⬜⬛⬛⬛⬛⬛⬛⬜⬜
⬜⬜⬛⬛⬛⬜⬜⬛⬛⬜⬜⬜⬜⬜⬜⬛⬜⬛⬛⬛⬛⬜⬛⬜⬜⬛⬛⬛⬜⬜⬛⬛⬛⬛⬜⬜⬜⬜⬜⬛⬛⬛⬛⬜⬛⬛⬛⬛⬜⬛⬛⬛⬛⬛⬜
⬜⬜⬜⬜⬜⬜⬜⬜⬜⬜⬜⬜⬜⬜⬜⬜⬜⬜⬜⬜⬜⬜⬜⬜⬜⬜⬜⬜⬜⬜⬜⬜⬜⬜⬜⬜⬜⬜⬜⬜⬜⬜⬜⬜⬜⬜⬜⬜⬜⬜⬜⬜⬜⬜⬜
