⬜⬜⬜⬜⬜⬜⬜⬜⬜⬜⬜⬜⬜⬜⬜⬜⬜⬜⬜⬜⬜⬜⬜⬜⬜⬜⬜⬜⬜⬜⬜⬜⬜⬜⬜⬜⬜⬜⬜⬜⬜⬜⬜⬜⬜⬜⬜⬜⬜⬜⬜⬜⬜⬜⬜
⬜⬛⬛⬛⬛⬛⬜⬜⬛⬜⬛⬜⬛⬛⬛⬛⬜⬜⬛⬛⬛⬛⬛⬛⬜⬛⬜⬛⬛⬜⬛⬛⬛⬛⬜⬜⬛⬛⬛⬛⬛⬛⬛⬛⬛⬛⬜⬛⬜⬜⬜⬜⬛⬜⬜
⬜⬛⬛⬛⬛⬛⬛⬛⬜⬛⬛⬜⬛⬛⬛⬛⬛⬛⬛⬛⬛⬛⬛⬜⬜⬜⬛⬛⬛⬜⬛⬛⬜⬜⬛⬛⬛⬜⬛⬛⬜⬛⬛⬜⬜⬜⬛⬜⬛⬛⬛⬜⬛⬛⬜
⬜⬛⬛⬜⬛⬜⬛⬜⬛⬛⬛⬛⬛⬛⬛⬜⬜⬜⬜⬜⬜⬛⬜⬛⬛⬛⬜⬛⬛⬛⬛⬛⬜⬜⬛⬜⬛⬛⬜⬛⬜⬛⬛⬛⬛⬛⬛⬛⬜⬜⬛⬜⬛⬛⬜
⬜⬜⬜⬜⬛⬜⬛⬛⬛⬛⬛⬛⬛⬜⬜⬛⬛⬛⬛⬜⬛⬛⬛⬜⬜⬛⬜⬜⬛⬛⬛⬛⬜⬛⬛⬜⬜⬛⬜⬛⬛⬛⬜⬜⬛⬜⬜⬛⬜⬛⬜⬜⬛⬛⬜
⬜⬛⬛⬛⬛⬛⬜⬛⬛⬛⬛⬛⬛⬛⬛⬜⬜⬜⬛⬜⬛⬛⬛⬛⬜⬛⬜⬜⬛⬛⬜⬛⬛⬜⬛⬜⬛⬜⬛⬜⬜⬜⬛⬜⬛⬜⬛⬛⬜⬛⬜⬛⬛⬛⬜
⬜⬜⬛⬛⬜⬛⬜⬛⬛⬛⬛⬜⬜⬛⬜⬛⬛⬛⬛⬛⬜⬛⬛⬛⬛⬛⬛⬛⬛⬜⬜⬜⬜⬛⬛⬜⬛⬛⬛⬛⬛⬛⬜⬛⬛⬛⬜⬛⬜⬛⬜⬛⬛⬛⬜
⬜⬛⬛⬜⬜⬛⬛⬜⬛⬛⬛⬜⬜⬛⬜⬛⬜⬜⬜⬛⬜⬛⬛⬛⬜⬜⬜⬛⬜⬛⬛⬛⬜⬛⬛⬜⬛⬛⬛⬜⬛⬜⬜⬛⬜⬛⬛⬛⬜⬜⬜⬛⬛⬛⬜
⬜⬛⬛⬛⬛⬜⬛⬜⬛⬛⬛⬜⬛⬛⬜⬜⬛⬛⬛⬛⬛⬛⬛⬛⬜⬛⬛⬛⬛⬛⬜⬛⬛⬛⬛⬛⬜⬜⬜⬜⬛⬛⬛⬛⬜⬜⬜⬜⬛⬛⬛⬜⬛⬛⬜
⬜⬜⬜⬛⬜⬛⬛⬛⬛⬛⬛⬜⬛⬛⬛⬛⬜⬜⬛⬜⬜⬜⬛⬜⬛⬛⬜⬜⬜⬜⬛⬜⬛⬛⬛⬜⬛⬛⬛⬛⬜⬛⬜⬜⬛⬛⬛⬛⬜⬜⬛⬛⬜⬜⬜
⬜⬛⬛⬛⬜⬛⬛⬜⬜⬜⬜⬛⬛⬜⬜⬛⬛⬛⬛⬜⬛⬛⬜⬛⬜⬛⬛⬛⬛⬛⬜⬜⬛⬛⬛⬛⬛⬛⬜⬜⬛⬛⬛⬜⬛⬜⬜⬜⬛⬛⬜⬛⬜⭐⬜
⬜⬜⬜⬜⬛⬛⬛⬛⬛⬛⬜⬛⬜⬛⬛⬛⬛⬛⬛⬛⬛⬜⬛⬛⬛⬜⬛⬜⬜⬜⬛⬛⬛⬜⬜⬜⬜⬛⬛⬛⬛⬛⬛⬛⬛⬛⬛⬛⬜⬜⬛⬜⬛⬛⬜
⬜⬛⬛⬛⬛⬛⬛⬜⬜⬜⬜⬛⬜⬜⬜⬛⬛⬛⬛⬜⬛⬜⬜⬜⬜⬜⬜⬛⬛⬛⬜⬜⬛⬛⬛⬛⬛⬛⬜⬛⬛⬛⬛⬜⬜⬜⬜⬛⬛⬛⬛⬛⬛⬜⬜
⬜⬜⬜⬜⬛⬛⬛⬛⬜⬛⬛⬛⬛⬛⬛⬛⬛⬛⬛⬜⬛⬛⬛⬛⬛⬛⬛⬛⬛⬛⬛⬛⬜⬜⬜⬛⬛⬛⬜⬜⬛⬛⬜⬛⬛⬛⬛⬛⬛⬛⬛⬛⬛⬜⬜
⬜⬛⬛⬛⬜⬛⬛⬛⬛⬜⬜⬛⬛⬜⬜⬛⬛⬜⬜⬛⬜⬜⬜⬛⬛⬜⬜⬜⬜⬛⬛⬛⬜⬛⬛⬛⬛⬛⬜⬛⬛⬛⬛⬜⬜⬜⬛⬛⬜⬛⬛⬜⬛⬛⬜
⬜⬜⬜⬛⬜⬛⬜⬜⬛⬛⬛⬜⬜⬜⬛⬜⬜⬛⬛⬛⬜⬛⬛⬛⬛⬛⬛⬛⬜⬛⬛⬛⬛⬜⬛⬜⬛⬜⬜⬛⬜⬜⬜⬛⬛⬛⬜⬜⬜⬛⬜⬛⬜⬛⬜
⬜⬛⬜⬛⬜⬛⬛⬛⬛⬜⬛⬛⬛⬛⬛⬛⬛⬛⬜⬜⬛⬛⬜⬜⬜⬛⬜⬛⬜⬛⬛⬛⬜⬜⬛⬛⬜⬛⬜⬛⬜⬛⬛⬛⬜⬜⬛⬛⬜⬛⬜⬛⬛⬜⬜
⬜⬜⬛⬜⬛⬜⬜⬜⬛⬜⬛⬛⬛⬛⬛⬜⬛⬛⬜⬛⬜⬜⬛⬛⬛⬛⬜⬛⬜⬛⬛⬜⬛⬜⬛⬜⬜⬛⬛⬛⬜⬛⬜⬜⬛⬛⬛⬛⬜⬛⬜⬛⬛⬛⬜
⬜⬛⬛⬜⬛⬛⬛⬛⬜⬜⬛⬛⬛⬛⬜⬛⬛⬜⬛⬜⬛⬜⬛⬜⬛⬜⬛⬛⬜⬛⬜⬜⬛⬛⬛⬛⬛⬜⬜⬜⬛⬛⬛⬛⬛⬛⬛⬛⬛⬛⬜⬛⬜⬜⬜
⬜⬛⬜⬛⬜⬜⬛⬛⬛⬜⬛⬜⬛⬛⬜⬜⬛⬜⬛⬛⬛⬜⬛⬜⬜⬛⬜⬜⬛⬜⬛⬛⬛⬜⬜⬜⬜⬛⬛⬛⬛⬜⬜⬜⬜⬜⬜⬛⬛⬛⬛⬛⬛⬛⬜
⬜⬛⬜⬛⬜⬛⬛⬛⬜⬜⬛⬜⬛⬛⬛⬛⬜⬜⬛⬜⬛⬛⬜⬛⬛⬛⬛⬛⬛⬛⬜⬛⬜⬛⬛⬛⬜⬜⬛⬛⬜⬛⬛⬛⬛⬛⬜⬜⬜⬛⬜⬛⬜⬜⬜
⬜⬜⬛⬛⬜⬛⬜⬛⬛⬛⬜⬛⬜⬜⬜⬜⬛⬛⬜⬜⬜⬛⬛⬜⬜⬜⬛⬜⬛⬜⬛⬜⬛⬛⬜⬛⬛⬛⬛⬛⬜⬛⬛⬛⬜⬛⬛⬛⬛⬛⬜⬛⬛⬛⬜
⬜⬛⬜⬛⬛⬛⬛⬜⬜⬛⬜⬛⬛⬛⬛⬛⬜⬜⬛⬛⬛⬛⬛⬛⬛⬛⬛⬜⬛⬜⬛⬜⬛⬛⬜⬜⬛⬜⬜⬛⬜⬛⬛⬛⬜⬜⬜⬜⬛⬜⬜⬛⬛⬛⬜
⬜⬜⬜⬜⬜⬛⬛⬜⬛⬛⬜⬛⬛⬛⬜⬛⬛⬛⬜⬜⬜⬜⬛⬜⬜⬜⬛⬜⬛⬜⬛⬜⬛⬛⬛⬛⬛⬜⬛⬜⬛⬜⬜⬛⬜⬛⬛⬛⬛⬜⬛⬛⬛⬛⬜
⬜⬛⬛⬛⬛⬛⬜⬜⬛⬜⬛⬛⬛⬛⬜⬛⬛⬛⬛⬛⬛⬛⬜⬛⬛⬛⬜⬜⬛⬛⬛⬜⬛⬜⬛⬜⬛⬜⬛⬛⬛⬛⬛⬜⬛⬛⬜⬜⬛⬛⬜⬜⬛⬛⬜
⬜⬜⬜⬜⬜⬜⬛⬜⬛⬜⬜⬛⬛⬛⬜⬛⬜⬛⬛⬜⬜⬛⬛⬜⬛⬜⬛⬛⬜⬜⬜⬜⬛⬜⬛⬜⬛⬜⬛⬛⬜⬜⬜⬛⬛⬛⬜⬛⬛⬜⬛⬜⬛⬜⬜
⬜⬜⬛⬛⬛⬛⬛⬛⬛⬛⬛⬜⬜⬜⬛⬛⬛⬜⬛⬜⬛⬛⬜⬜⬛⬛⬛⬛⬛⬛⬛⬜⬛⬜⬛⬜⬛⬜⬛⬛⬛⬛⬛⬜⬜⬛⬛⬛⬜⬜⬛⬛⬛⬛⬜
⬜⬛⬛⬜⬜⬜⬛⬛⬛⬛⬛⬜⬛⬜⬛⬜⬛⬜⬛⬜⬛⬜⬛⬛⬜⬛⬛⬛⬛⬛⬜⬛⬜⬛⬜⬛⬛⬛⬜⬜⬛⬜⬜⬛⬛⬜⬜⬜⬛⬜⬛⬛⬛⬛⬜
⬜⬛⬜⬛⬛⬛⬛⬜⬛⬜⬛⬜⬛⬜⬛⬜⬛⬜⬛⬜⬛⬛⬜⬛⬜⬛⬛⬛⬜⬛⬜⬛⬜⬛⬜⬛⬜⬛⬛⬛⬛⬛⬛⬜⬜⬛⬛⬛⬜⬜⬛⬛⬛⬛⬜
⬜⬛⬜⬛⬜⬜⬛⬜⬛⬜⬛⬜⬛⬛⬛⬛⬛⬛⬜⬛⬜⬛⬛⬛⬜⬛⬛⬜⬜⬜⬛⬛⬜⬛⬛⬛⬜⬛⬜⬜⬜⬛⬛⬛⬜⬛⬜⬜⬛⬛⬜⬛⬜⬛⬜
⬜⬛⬛⬛⬛⬜⬛⬜⬛⬜⬛⬜⬛⬜⬜⬜⬜⬛⬜⬛⬜⬛⬜⬜⬛⬜⬜⬛⬛⬛⬛⬜⬛⬜⬛⬜⬜⬜⬛⬛⬜⬜⬜⬜⬛⬛⬛⬛⬛⬛⬛⬜⬛⬛⬜
⬜⬛⬜⬛⬜⬛⬛⬜⬛⬜⬛⬜⬛⬜⬛⬛⬛⬛⬜⬛⬜⬛⬜⬛⬜⬛⬛⬜⬜⬜⬜⬜⬛⬜⬛⬛⬛⬜⬛⬜⬛⬛⬜⬛⬛⬜⬛⬜⬜⬛⬛⬜⬛⬛⬜
⬜⬜⬛⬛⬜⬜⬛⬜⬜⬜⬛⬛⬛⬜⬛⬜⬛⬛⬛⬛⬜⬛⬜⬛⬛⬛⬜⬛⬛⬛⬛⬜⬛⬛⬛⬜⬜⬛⬛⬜⬜⬛⬛⬛⬛⬜⬛⬜⬛⬛⬛⬛⬛⬛⬜
⬜⬜⬛⬜⬛⬛⬛⬛⬛⬛⬜⬜⬛⬛⬜⬛⬛⬜⬜⬛⬜⬛⬜⬛⬜⬛⬛⬛⬜⬜⬜⬜⬛⬜⬜⬛⬛⬜⬜⬜⬛⬛⬛⬛⬛⬛⬛⬜⬜⬜⬛⬛⬛⬛⬜
⬜⬛⬛⬜⬛⬜⬜⬛⬜⬛⬛⬜⬛⬛⬛⬜⬜⬛⬜⬛⬜⬛⬛⬛⬜⬛⬜⬜⬛⬛⬛⬛⬛⬜⬛⬜⬛⬛⬛⬛⬜⬛⬛⬛⬛⬛⬜⬛⬛⬛⬛⬜⬜⬛⬜
⬜⬛⬛⬜⬛⬛⬜⬛⬜⬛⬜⬛⬛⬜⬜⬛⬜⬛⬜⬛⬜⬛⬜⬛⬜⬛⬛⬛⬛⬛⬛⬛⬛⬛⬛⬛⬛⬜⬛⬜⬜⬜⬜⬛⬛⬜⬜⬜⬛⬛⬜⬛⬛⬜⬜
⬜⬜⬛⬜⬛⬜⬛⬜⬛⬛⬜⬜⬛⬛⬛⬜⬛⬛⬜⬛⬜⬛⬜⬛⬜⬛⬛⬜⬜⬜⬛⬛⬜⬜⬜⬜⬛⬜⬛⬛⬛⬛⬛⬜⬛⬛⬛⬛⬛⬛⬜⬜⬛⬜⬜
⬜⬜⬛⬛⬛⬜⬛⬜⬛⬜⬜⬛⬛⬜⬛⬛⬛⬛⬛⬛⬛⬜⬜⬛⬜⬜⬜⬛⬛⬛⬜⬛⬛⬛⬛⬛⬜⬛⬜⬛⬜⬛⬜⬛⬜⬜⬜⬛⬛⬛⬛⬛⬛⬜⬜
⬜⬜⬜⬛⬜⬜⬛⬛⬛⬛⬛⬛⬜⬛⬛⬛⬛⬛⬛⬛⬛⬛⬛⬛⬜⬛⬛⬜⬛⬛⬜⬜⬛⬛⬛⬛⬛⬛⬜⬛⬜⬛⬜⬛⬛⬛⬛⬜⬛⬛⬛⬜⬜⬛⬜
⬜⬜⬛⬛⬛⬛⬜⬛⬜⬜⬛⬛⬜⬛⬜⬜⬛⬜⬜⬛⬜⬛⬜⬛⬜⬛⬜⬜⬜⬛⬛⬛⬜⬛⬛⬛⬛⬛⬜⬜⬜⬛⬜⬛⬛⬜⬛⬛⬛⬛⬛⬛⬛⬛⬜
⬜⬛⬛⬜⬛⬜⬜⬛⬛⬛⬛⬛⬜⬛⬜⬛⬛⬛⬛⬛⬜⬛⬜⬛⬜⬛⬛⬛⬛⬛⬛⬜⬜⬛⬜⬛⬜⬜⬛⬛⬛⬛⬛⬜⬜⬛⬛⬛⬛⬛⬜⬜⬜⬜⬜
⬜⬛⬜⬛⬜⬛⬛⬛⬜⬜⬜⬜⬛⬛⬛⬛⬜⬛⬛⬜⬛⬛⬛⬛⬛⬛⬛⬛⬛⬜⬛⬛⬛⬜⬜⬛⬛⬜⬜⬛⬛⬛⬛⬛⬛⬜⬛⬛⬛⬜⬛⬛⬛⬛⬜
⬜⬜⬛⬛⬜⬛⬜⬛⬛⬛⬛⬛⬛⬛⬜⬜⬛⬜⬜⬛⬜⬛⬜⬜⬛⬛⬜⬛⬜⬜⬛⬜⬜⬛⬛⬜⬛⬛⬛⬜⬛⬜⬜⬜⬛⬜⬛⬛⬛⬛⬜⬛⬜⬛⬜
⬜⬛⬜⬛⬜⬛⬜⬛⬜⬛⬜⬛⬛⬛⬛⬛⬛⬛⬛⬛⬜⬛⬜⬛⬛⬜⬜⬛⬛⬛⬛⬛⬛⬜⬜⬛⬛⬜⬜⬛⬜⬛⬜⬛⬛⬛⬛⬜⬛⬛⬜⬛⬛⬜⬜
⬜⬛⬛⬛⬛⬛⬜⬛⬛⬜⬜⬛⬜⬜⬜⬜⬜⬛⬛⬛⬜⬛⬛⬛⬜⬛⬜⬛⬜⬜⬜⬜⬜⬜⬛⬜⬜⬛⬜⬛⬜⬛⬛⬛⬛⬜⬜⬜⬛⬜⬛⬜⬛⬜⬜
⬜⬛⬛⬛⬛⬛⬜⬛⬜⬛⬛⬜⬛⬜⬛⬛⬛⬛⬛⬛⬜⬛⬜⬛⬜⬛⬜⬛⬛⬛⬜⬛⬛⬛⬛⬛⬛⬛⬜⬛⬛⬜⬛⬜⬛⬛⬛⬜⬛⬜⬛⬜⬛⬜⬜
⬜⬛⬜⬜⬜⬜⬛⬜⬛⬛⬜⬛⬛⬜⬛⬛⬜⬜⬜⬛⬜⬛⬜⬛⬜⬛⬜⬜⬜⬜⬛⬛⬜⬜⬛⬜⬜⬛⬜⬜⬛⬜⬛⬜⬛⬜⬜⬜⬛⬜⬛⬛⬜⬛⬜
⬜⬛⬛⬛⬛⬜⬛⬛⬛⬛⬛⬜⬛⬜⬜⬜⬜⬜⬛⬛⬛⬛⬜⬛⬛⬜⬜⬛⬛⬛⬜⬛⬜⬛⬜⬛⬜⬛⬜⬛⬛⬜⬛⬛⬜⬛⬛⬜⬛⬜⬜⬛⬜⬜⬜
⬜⬜⬜⬛⬛⬛⬛⬜⬛⬜⬜⬛⬜⬛⬛⬛⬛⬛⬛⬜⬜⬛⬜⬜⬛⬜⬛⬛⬜⬛⬜⬛⬜⬛⬜⬛⬛⬜⬛⬜⬛⬛⬛⬛⬜⬜⬛⬛⬛⬛⬛⬛⬛⬛⬜
⬜⬛⬛⬛⬛⬛⬜⬜⬛⬜⬜⬛⬜⬛⬜⬛⬛⬛⬜⬛⬛⬛⬛⬜⬛⬜⬜⬜⬜⬛⬜⬜⬛⬛⬛⬜⬛⬛⬜⬛⬛⬛⬛⬛⬛⬜⬜⬜⬜⬛⬛⬛⬜⬜⬜
⬜⬛*️⃣⬛⬛⬜⬛⬜⬛⬛⬜⬛⬜⬛⬜⬜⬜⬛⬜⬜⬜⬛⬛⬜⬛⬜⬛⬛⬜⬛⬜⬛⬛⬜⬛⬜⬜⬛⬛⬛⬛⬛⬛⬜⬛⬛⬛⬛⬜⬛⬛⬛⬛⬛⬜
⬜⬛⬛⬛⬛⬜⬛⬜⬛⬛⬜⬛⬜⬛⬛⬛⬜⬛⬛⬛⬜⬛⬛⬜⬛⬛⬛⬜⬛⬛⬜⬜⬜⬛⬜⬛⬛⬜⬛⬜⬛⬛⬛⬛⬜⬛⬜⬛⬛⬛⬜⬜⬜⬜⬜
⬜⬛⬛⬜⬜⬜⬛⬜⬜⬜⬛⬛⬜⬛⬜⬜⬛⬜⬜⬛⬛⬜⬛⬛⬜⬜⬛⬛⬛⬜⬛⬜⬛⬛⬛⬜⬛⬜⬜⬜⬜⬛⬛⬛⬛⬛⬛⬜⬜⬛⬛⬛⬛⬜⬜
⬜⬜⬛⬛⬛⬜⬛⬛⬛⬛⬜⬛⬜⬛⬛⬜⬛⬛⬛⬜⬜⬛⬛⬜⬛⬛⬜⬜⬜⬜⬛⬛⬜⬜⬛⬜⬛⬛⬛⬛⬛⬛⬛⬛⬜⬜⬛⬛⬜⬜⬜⬜⬜⬛⬜
⬜⬜⬜⬜⬜⬜⬜⬜⬜⬜⬜⬜⬜⬜⬜⬜⬜⬜⬜⬜⬜⬜⬜⬜⬜⬜⬜⬜⬜⬜⬜⬜⬜⬜⬜⬜⬜⬜⬜⬜⬜⬜⬜⬜⬜⬜⬜⬜⬜⬜⬜⬜⬜⬜⬜
