⬜⬜⬜⬜⬜⬜⬜⬜⬜⬜⬜⬜⬜⬜⬜⬜⬜⬜⬜⬜⬜⬜⬜⬜⬜⬜⬜⬜⬜⬜⬜⬜⬜⬜⬜⬜⬜⬜⬜⬜⬜⬜⬜⬜⬜⬜⬜⬜⬜⬜⬜⬜⬜⬜⬜
⬜⬜⬜⬜⬛⬛⬛⬜⬛⬜⬛⬛⬜⬛⬛⬛⬛⬛⬛⬛⬜⬛⬛⬜⬛⬛⬛⬜⬜⬛⬛⬛⬛⬛⬛⬜⬜⬜⬜⬛⬛⬛⬜⬜⬜⬜⬛⬛⬜⬜⬛⬜⬜⬛⬜
⬜⬛⬛⬜⬛⬛⬛⬜⬛⬜⬛⬜⬛⬜⬛⬛⬛⬛⬛⬛⬛⬜⬛⬛⬛⬛⬛⬛⬜⬛⬛⬛⬜⬜⬜⬛⬛⬛⬛⬛*️⃣⬛⬛⬜⬛⬛⬛⬛⬜⬛⬛⬛⬛⬛⬜
⬜⬜⬛⬛⬜⬛⬛⬜⬛⬛⬛⬛⬜⬛⬜⬜⬜⬛⬛⬜⬜⬛⬜⬜⬜⬜⬛⬛⬜⬛⬜⬜⬛⬛⬛⬛⬜⬜⬛⬛⬛⬛⬛⬛⬜⬛⬜⬛⬛⬜⬜⬛⬜⬜⬜
⬜⬛⬜⬜⬜⬛⬜⬛⬜⬛⬜⬜⬜⬛⬜⬛⬛⬜⬜⬛⬜⬛⬛⬛⬛⬛⬜⬛⬛⬛⬛⬛⬜⬜⬜⬜⬛⬛⬛⬜⬛⬜⬛⬛⬛⬜⬜⬛⬛⬛⬜⬛⬛⬜⬜
⬜⬛⬛⬛⬛⬛⬛⬛⬛⬛⬛⬛⬛⬛⬜⬛⬜⬛⬜⬛⬜⬛⬜⬛⬛⬜⬜⬛⬛⬜⬜⬜⬛⬛⬛⬛⬛⬛⬜⬜⬜⬛⬛⬜⬛⬜⬛⬛⬛⬛⬛⬜⬛⬜⬜
⬜⬜⬜⬛⬛⬜⬜⬜⬜⬛⬛⬛⬛⬛⬛⬜⬛⬛⬛⬜⬜⬛⬜⬛⬜⬜⬛⬛⬜⬛⬛⬛⬛⬜⬜⬛⬛⬛⬛⬛⬛⬛⬛⬛⬜⬛⬜⬜⬜⬛⬛⬜⬛⬜⬜
⬜⬜⬛⬛⬛⬛⬛⬜⬛⬛⬜⬜⬜⬛⬛⬛⬛⬜⬛⬛⬛⬛⬜⬛⬜⬛⬛⬛⬛⬜⬜⬛⬛⬛⬛⬛⬛⬛⬜⬜⬜⬜⬛⬛⬜⬛⬜⬛⬛⬜⬛⬛⬛⬜⬜
⬜⬛⬛⬜⬛⬛⬛⬜⬛⬜⬛⬛⬛⬛⬛⬛⬛⬛⬜⬜⬜⬛⬜⬛⬜⬛⬛⬜⬛⬛⬛⬜⬜⬜⬜⬛⬜⬜⬛⬛⬛⬛⬜⬛⬜⬛⬛⬜⬛⬛⬜⬜⬜⬜⬜
⬜⬛⬜⬜⬜⬛⬛⬛⬛⬜⬛⬜⬛⬛⬛⬛⬛⬜⬛⬛⬛⬜⬛⬛⬜⬜⬛⬜⬛⬜⬛⬜⬛⬛⬜⬛⬜⬜⬛⬛⬜⬛⬛⬛⬛⬜⬛⬜⬛⬜⬛⬛⬛⬛⬜
⬜⬛⬛⬛⬛⬜⬜⬜⬛⬛⬛⬛⬜⬛⬜⬛⬛⬛⬛⬛⬜⬜⬛⬛⬜⬛⬜⬜⬛⬜⬛⬜⬛⬛⬜⬛⬛⬛⬛⬜⬛⬜⬜⬜⬛⬛⬛⬜⬛⬜⬛⬜⬜⬜⬜
⬜⬛⬛⬛⬜⬛⬛⬛⬛⬜⬜⬛⬜⬛⬛⬜⬛⬛⬛⬜⬛⬛⬜⬛⬛⬛⬛⬛⬛⬜⬛⬛⬜⬛⬜⬛⬜⬜⬛⬛⬛⬛⬛⬛⬜⬜⬛⬜⬛⬜⬛⬜⬛⬛⬜
⬜⬛⬛⬛⬛⬛⬜⬜⬛⬛⬛⬜⬛⬜⬛⬜⬜⬛⬛⬜⬜⬜⬜⬛⬛⬛⬜⬛⬜⬜⬛⬛⬜⬜⬜⬛⬛⬛⬜⬛⬛⬜⬜⬛⬜⬛⬛⬜⬛⬜⬛⬜⬛⬛⬜
⬜⬜⬜⬜⬜⬜⬛⬜⬛⬜⬜⬛⬛⬛⬛⬜⬛⬛⬛⬛⬛⬛⬛⬛⬛⬜⬛⬛⬛⬛⬛⬜⬛⬛⬛⬜⬛⬜⬛⬜⬜⬛⬛⬛⬜⬛⬛⬛⬛⬛⬛⬜⬛⬛⬜
⬜⬜⬛⬛⬛⬛⬜⬛⬛⬛⬜⬜⬛⬛⬛⬛⬛⬛⬛⬜⬛⬜⬜⬜⬛⬜⬛⬜⬛⬜⬜⬜⬛⬜⬛⬛⬜⬛⬜⬛⬛⬛⬜⬜⬜⬜⬜⬜⬜⬛⬜⬛⬛⬜⬜
⬜⬛⬛⬜⬛⬛⬜⬛⬛⬛⬛⬛⬜⬛⬜⬛⬛⬜⬜⬛⬛⬛⬛⬜⬛⬜⬛⬜⬛⬜⬛⬛⬛⬜⬛⬛⬛⬛⬜⬛⬛⬛⬜⬛⬛⬛⬛⬛⬛⬛⬜⬜⬛⬛⬜
⬜⬛⬛⬜⬛⬜⬛⬜⬜⬛⬜⬜⬛⬛⬛⬜⬛⬛⬜⬜⬛⬛⬛⬜⬛⬜⬛⬜⬛⬛⬛⬜⬛⬜⬛⬛⬜⬛⬜⬛⬜⬛⬜⬛⬜⬜⬛⬜⬜⬜⬛⬛⬜⬛⬜
⬜⬛⬛⬜⬛⬜⬛⬛⬛⬛⬛⬛⬛⬛⬛⬜⬛⬛⬛⬛⬛⬛⬜⬜⬛⬜⬛⬜⬛⬛⬜⬛⬜⬛⬛⬜⬛⬛⬛⬛⬜⬛⬜⬛⬛⬛⬛⬛⬛⬜⬜⬜⬛⬜⬜
⬜⬜⬜⬛⬜⬜⬜⬛⬛⬜⬜⬛⬜⬜⬛⬜⬛⬜⬛⬛⬛⬛⬛⬜⬛⬜⬜⬛⬜⬜⬛⬛⬜⬛⬜⬛⬜⬜⬛⬜⬛⬛⬜⬛⬛⬜⬜⬛⬛⬛⬛⬜⬜⬛⬜
⬜⬛⬜⬛⬛⬛⬛⬜⬛⬛⬜⬛⬜⬛⬛⬛⬜⬛⬛⬛⬛⬛⬜⬜⬛⬛⬛⬛⬛⬛⬜⬜⬛⬜⬛⬜⬛⬛⬛⬜⬛⬛⬛⬛⬜⬜⬛⬜⬛⬜⬛⬛⬛⬛⬜
⬜⬛⬛⬛⬛⬜⬛⬛⬜⬛⬜⬛⬜⬛⬜⬛⬛⬛⬛⬛⬛⬜⬛⬛⬜⬛⬛⬜⬜⬜⬛⬛⬛⬛⬛⬜⬛⬜⬛⬛⬜⬛⬛⬛⬜⬛⬛⬜⬛⬜⬛⬛⬜⬛⬜
⬜⬜⬜⬜⬛⬜⬜⬛⬛⬛⬛⬛⬜⬛⬜⬜⬜⬛⬜⬜⬛⬜⬛⬛⬛⬛⬛⬜⬛⬛⬛⬜⬜⬜⬛⬜⬛⬜⬛⬜⬛⬜⬜⬜⬛⬜⬛⬜⬛⬜⬛⬜⬜⬛⬜
⬜⬛⬛⬛⬜⬛⬛⬜⬛⬛⬛⬛⬜⬛⬛⬛⬛⬛⬛⬜⬛⬜⬛⬛⬛⬛⬛⬛⬛⬜⬜⬛⬛⬛⬛⬛⬛⬜⬛⬜⬛⬜⬛⬛⬛⬜⬛⬛⬛⬜⬜⬛⬜⬛⬜
⬜⬜⬛⬜⬛⬜⬛⬛⬛⬜⬛⬜⬜⬛⬛⬜⬜⬛⬜⬛⬛⬛⬛⬛⬛⬜⬜⬜⬜⬛⬛⬜⬛⬛⬜⬜⬛⬜⬛⬜⬛⬜⬛⬛⬜⬜⬛⬜⬛⬛⬛⬛⬛⬛⬜
⬜⬜⬜⬛⬜⬛⬛⬜⬜⬜⬜⬛⬛⬜⬜⬛⬛⬛⬜⬛⬛⬜⬜⬜⬛⬛⬛⬛⬛⬜⬛⬜⬛⬜⬛⬛⬛⬜⬛⬜⬛⬜⬛⬜⬜⬛⬛⬜⬛⬜⬛⬜⬜⬛⬜
⬜⬛⬛⬛⬜⬛⬜⬛⬛⬛⬛⬜⬛⬜⬛⬛⬛⬛⬛⬜⬛⬜⬛⬛⬛⬜⬜⬛⬛⬜⬜⬛⬛⬜⬛⬛⬛⬛⬜⬛⬛⬜⬛⬜⬛⬛⬛⬛⬛⬜⬜⬛⬛⬛⬜
⬜⬛⬛⬜⬜⬛⬜⬛⬜⬜⬛⬜⬛⬜⬛⬜⬜⬜⬜⬛⬛⬜⬛⬜⬛⬛⬛⬛⬛⬜⬛⬛⬛⬜⬛⬛⬛⬜⬜⬛⬛⬜⬛⬜⬛⬛⬜⬜⬛⬛⬜⬛⬜⬜⬜
⬜⬛⬛⬛⬛⬛⬛⬛⬛⬛⬛⬜⬛⬜⬛⬜⬛⬛⬛⬛⬜⬛⬛⬛⬜⬜⬛⬜⬛⬜⬛⬛⬛⬛⬜⬛⬛⬜⬛⬜⬛⬛⬛⬜⬛⬜⬛⬛⬛⬛⬛⬜⬛⬛⬜
⬜⬜⬜⬜⬜⬜⬜⬛⬛⬛⬛⬜⬜⬜⬛⬜⬛⬜⬛⬛⬜⬛⬜⬛⬜⬛⬜⬛⬜⬛⬛⬛⬛⬛⬛⬜⬛⬜⬛⬛⬛⬜⬛⬜⬛⬜⬛⬛⬛⬛⬜⬜⬛⬛⬜
⬜⬛⬛⬛⬛⬛⬛⬛⬜⬜⬛⬛⬛⬛⬛⬛⬛⬜⬜⬛⬜⬛⬜⬛⬜⬛⬜⬛⬜⬛⬜⬜⬜⬜⬜⬛⬛⬜⬜⬛⬜⬛⬛⬜⬛⬜⬜⬜⬛⬛⬛⬛⬛⬛⬜
⬜⬛⬛⬜⬛⬜⬜⬜⬛⬛⬜⬜⬛⬛⬜⬛⬛⬛⬜⬛⬛⬛⬜⬛⬛⬜⬛⬛⬜⬛⬜⬛⬛⬛⬛⬜⬛⬜⬛⬜⬛⬛⬛⬜⬛⬛⬛⬛⬜⬜⬜⬜⬜⬛⬜
⬜⬜⬛⬜⬛⬛⬛⬛⬜⬛⬛⬜⬛⬜⬛⬜⬜⬜⬛⬜⬜⬛⬛⬛⬛⬛⬛⬛⬛⬛⬛⬜⬜⬛⬛⬜⬛⬛⬛⬛⬜⬜⬜⬛⬜⬜⬜⬛⬜⬛⬛⬛⬜⬜⬜
⬜⬛⬛⬜⬛⬜⬜⬛⬛⬛⬜⬛⬛⬜⬛⬜⬛⬜⬛⬜⬛⬛⬛⬜⬜⬜⬛⬛⬛⬜⬜⬛⬛⬜⬜⬛⬜⬛⬛⬛⬛⬛⬛⬛⬛⬛⬛⬜⬛⬛⬜⬜⬛⬛⬜
⬜⬜⬛⬛⬜⬜⬛⬛⬛⬜⬛⬜⬛⬛⬛⬛⬛⬛⬛⬛⬜⬜⬜⬛⬛⬛⬛⬜⬛⬛⬛⬜⬛⬜⬛⬛⬜⬛⬛⬛⬜⬜⬛⬜⬛⬜⬛⬛⬜⬜⬛⬛⬛⬜⬜
⬜⬜⬛⬜⬛⬛⬛⬛⬛⬛⬜⬜⬛⬜⬜⬜⬛⬛⬛⬛⬛⬛⬛⬛⬜⬜⬛⬜⬛⬜⬜⬛⬛⬛⬛⬛⬛⬛⬛⬛⬛⬛⬛⬛⬜⬜⬛⬜⬛⬛⬛⬜⬜⬜⬜
⬜⬜⬜⬛⬜⬛⬛⬜⬜⬛⬜⬛⬛⬛⬛⬛⬛⬛⬛⬜⬜⬜⬜⬜⬛⬜⬛⬜⬛⬜⬛⬛⬛⬛⬜⬜⬜⬜⬜⬜⬜⬛⬜⬛⬛⬛⬛⬜⬛⬜⬜⬛⬛⬛⬜
⬜⬛⬛⬛⬛⬛⬜⬛⬜⬛⬜⬛⬛⬜⬜⬛⬛⬛⬛⬜⬛⬛⬛⬛⬛⬜⬜⬛⬛⬜⬛⬛⬛⬛⬜⬛⬛⬛⬛⬛⬜⬛⬜⬜⬛⬛⬛⬛⬜⬛⬜⬜⬛⬛⬜
⬜⬜⬜⬛⬜⬛⬛⬛⬛⬛⬛⬛⬛⬛⬛⬛⬛⬜⬛⬜⬜⬜⬜⬛⬜⬛⬛⬛⬜⬛⬜⬛⬛⬛⬛⬜⬜⬜⬜⬛⬜⬛⬛⬛⬛⬛⬛⬛⬛⬛⬜⬛⬜⬛⬜
⬜⬜⬛⬛⬜⬛⬜⬜⬜⬜⬜⬛⬛⬛⬛⬛⬜⬛⬛⬛⬜⬛⬜⬜⬛⬛⬛⬜⬜⬛⬛⬛⬛⬛⬜⬛⬛⬜⬛⬛⬜⬜⬛⬛⬜⬜⬛⬛⬜⬛⬛⬛⬛⬜⬜
⬜⬛⬛⬛⬛⬜⬛⬛⬛⬛⬛⬜⬛⬛⬜⬛⬛⬜⬜⬛⬜⬛⬛⬛⬜⬜⬜⬛⬛⬜⬜⬛⬜⬜⬛⬜⬜⬛⬛⬜⬛⬜⬛⬛⬜⬛⬛⬜⬛⬛⬛⬜⬛⬜⬜
⬜⬛⬜⬛⬜⬛⬜⬛⬜⬜⬛⬜⬜⬛⬛⬜⬜⬛⬛⬛⬜⬛⬜⬜⬛⬛⬛⬜⬛⬜⬛⬜⬛⬜⬛⬛⬛⬛⬛⬜⬛⬜⬜⬛⬜⬛⬛⬛⬛⬜⬜⬛⬜⬛⬜
⬜⬛⬜⬛⬛⬛⬜⬛⬛⬜⬛⬜⬛⬜⬜⬛⬛⬛⬛⬜⬜⬛⬜⬛⬜⬛⬜⬜⬛⬛⬜⬛⬛⬜⬛⬜⬜⬜⬛⬛⬛⬛⬜⬛⬛⬛⬜⬜⬜⬛⬛⬛⬛⬜⬜
⬜⬛⬜⬛⬛⬜⬜⬜⬜⬛⬜⬜⬛⬛⬛⬛⬛⬛⬛⬛⬜⬛⬛⬛⬜⬛⬜⬛⬛⬛⬛⬜⬜⬛⬜⬛⬛⬛⬛⬜⬛⬜⬜⬛⬛⬛⬛⬛⬛⬜⬜⬛⬛⬛⬜
⬜⬛⬜⬛⬛⬛⬛⬛⬛⬛⬜⬛⬜⬜⬛⬜⬛⬛⬛⬛⬛⬜⬜⬛⬜⬛⬛⬜⬜⬛⬜⬛⬛⬛⬜⬛⬛⬛⬛⬜⬛⬜⬛⬛⬛⬛⬜⬜⬜⬜⬛⬛⬜⬛⬜
⬜⬜⬛⬜⬛⬜⬜⬜⬜⬜⬛⬛⬜⬜⬛⬛⬜⬛⬛⬜⬛⬛⬜⬛⬜⬛⬜⬛⬛⬛⬜⬛⬜⬜⬛⬛⬜⬜⬛⬜⬜⬛⬛⬜⬛⬛⬜⬛⬛⬛⬛⬜⬛⬛⬜
⬜⬛⬛⬜⬛⬜⬛⬛⬜⬛⬛⬛⬛⬛⬜⬛⬜⬛⬜⬛⬛⬜⬛⬛⬜⬛⬜⬛⬜⬛⬛⬛⬛⬛⬜⬛⬛⬛⬛⬛⬜⬛⬜⬛⬛⬛⬜⬛⬜⬜⬛⬛⬜⬜⬜
⬜⬛⬜⬜⬛⬜⬛⬛⬜⬛⬜⬜⬜⬜⬜⬛⬛⬜⬜⬛⬜⬛⬜⬛⬜⬛⬜⬛⬜⬜⬛⬜⬜⬛⬛⬛⬜⬜⬜⬛⬜⬜⬛⬜⬛⬜⬛⬛⬛⬜⬛⬜⬛⬛⬜
⬜⬛⬛⬛⬜⬛⬛⬜⬛⬜⬛⬛⬛⬛⬛⬛⬛⬛⬛⬛⬜⬛⬜⬛⬜⬛⬜⬛⬛⬛⬜⬛⬛⬜⬜⬜⬛⭐⬛⬛⬜⬛⬛⬜⬜⬜⬜⬛⬜⬜⬛⬜⬛⬜⬜
⬜⬛⬜⬜⬛⬜⬛⬛⬛⬛⬛⬛⬛⬛⬛⬜⬜⬜⬜⬛⬜⬛⬛⬛⬛⬛⬛⬛⬜⬜⬜⬛⬜⬛⬛⬛⬜⬜⬜⬛⬛⬜⬜⬛⬛⬛⬜⬛⬜⬛⬛⬜⬛⬜⬜
⬜⬜⬛⬜⬛⬛⬜⬜⬛⬜⬜⬛⬛⬜⬜⬛⬛⬛⬜⬛⬛⬜⬛⬛⬛⬜⬜⬛⬛⬛⬜⬛⬛⬜⬜⬛⬜⬛⬛⬜⬛⬜⬛⬛⬜⬛⬜⬛⬜⬛⬜⬛⬜⬛⬜
⬜⬜⬛⬛⬛⬜⬛⬛⬜⬛⬜⬛⬛⬛⬜⬛⬛⬛⬛⬛⬜⬛⬛⬛⬜⬛⬜⬛⬜⬜⬜⬛⬛⬛⬜⬛⬜⬛⬜⬜⬛⬜⬜⬛⬜⬛⬜⬛⬜⬛⬜⬛⬜⬛⬜
⬜⬜⬛⬜⬛⬛⬜⬛⬛⬛⬜⬛⬛⬛⬜⬛⬛⬛⬛⬛⬜⬛⬜⬛⬜⬛⬜⬛⬛⬛⬛⬛⬛⬛⬛⬛⬜⬛⬛⬛⬜⬛⬜⬛⬜⬛⬜⬛⬜⬛⬜⬛⬜⬛⬜
⬜⬜⬛⬜⬜⬛⬜⬛⬜⬜⬛⬛⬛⬛⬜⬛⬜⬜⬜⬜⬛⬜⬛⬛⬛⬛⬛⬛⬛⬜⬜⬛⬜⬛⬛⬛⬜⬜⬜⬛⬜⬛⬜⬛⬛⬜⬛⬛⬜⬛⬜⬛⬛⬛⬜
⬜⬜⬛⬜⬛⬜⬛⬜⬛⬛⬛⬛⬛⬛⬛⬛⬜⬜⬛⬛⬜⬛⬛⬜⬜⬜⬛⬛⬛⬜⬜⬛⬜⬛⬛⬜⬛⬛⬜⬛⬜⬜⬛⬛⬛⬛⬜⬜⬛⬛⬜⬛⬜⬜⬜
⬜⬜⬜⬜⬜⬜⬜⬜⬜⬜⬜⬜⬜⬜⬜⬜⬜⬜⬜⬜⬜⬜⬜⬜⬜⬜⬜⬜⬜⬜⬜⬜⬜⬜⬜⬜⬜⬜⬜⬜⬜⬜⬜⬜⬜⬜⬜⬜⬜⬜⬜⬜⬜⬜⬜
