⬜⬜⬜⬜⬜⬜⬜⬜⬜⬜⬜⬜⬜⬜⬜⬜⬜⬜⬜⬜⬜⬜⬜⬜⬜⬜⬜⬜⬜⬜⬜⬜⬜⬜⬜⬜⬜⬜⬜⬜⬜⬜⬜⬜⬜⬜⬜⬜⬜⬜⬜⬜⬜⬜⬜
⬜⬛⬜⬛⬛⬜⬛⬜⬜⬛⬜⬛⬜⬜⬛⬜⬛⬜⬛⬜⬜⬛⬜⬛⬛⬜⬛⬛⬜⬜⬜⬛⬛⬛⬜⬛⬛⬛⬜⬛⬛⬛⬛⬛⬛⬜⬜⬜⬛⬛⬜⬛⬜⬛⬜
⬜⬛⬜⬛⬛⬜⬜⬛⬛⬛⬛⬜⬛⬛⬜⬛⬛⬜⬛⬜⬛⬛⬜⬛⬛⬜⬛⬜⬛⬛⬛⬜⬜⬛⬛⬜⬜⬜⬜⬜⬛⬛⬛⬛⬛⬜⬛⬛⬛⬛⬜⬛⬛⬛⬜
⬜⬜⬛⬛⬜⬛⬛⬛⬜⬜⬜⬛⬜⬜⬛⬛⬜⬛⬜⬛⬛⬛⬛⬛⬛⬜⬛⬛⬛⬜⬛⬛⬛⬛⬜⬜⬛⬛⬛⬛⬛⬛⬛⬛⬜⬛⬛⬜⬜⬛⬛⬜⬜⬜⬜
⬜⬛⬜⬛⬛⬜⬛⬜⬛⬛⬛⬛⬛⬛⬜⬛⬜⬛⬛⬜⬜⬛⬛⬛⬛⬜⬛⬜⬜⬜⬛⬛⬜⬛⬛⬛⬜⬜⬛⬜⬛⬜⬜⬛⬜⬜⬛⬜⬛⬜⬛⬜⬛⬜⬜
⬜⬜⬜⬛⬜⬜⬛⬜⬛⬛⬜⬜⬜⬛⬜⬛⬛⬜⬜⬜⬛⬛⬛⬛⬛⬛⬛⬛⬛⬛⬜⬛⬜⬜⬜⬜⬛⬜⬛⬜⬛⬜⬛⬛⬛⬜⬛⬛⬛⬜⬛⬛⬛⬜⬜
⬜⬛⬛⬜⬛⬛⬛⬛⬜⬜⬛⬛⬛⬛⬛⬜⬜⬛⬛⬜⬛⬜⬜⬜⬛⬜⬜⬜⬜⬛⬛⬜⬛⬛⬛⬜⬛⬛⬛⬜⬛⬛⬜⬜⬜⬛⬛⬛⬛⬛⬛⬜⬜⬛⬜
⬜⬛⬛⬛⬛⬜⬜⬜⬛⬛⬛⬜⬛⬜⬛⬛⬛⬛⬛⬜⬛⬜⬛⬛⬜⬛⬜⬛⬛⬛⬛⬛⬛⬜⬛⬛⬛⬜⬛⬜⬛⬜⬛⬛⬛⬛⬜⬜⬜⬜⬛⬛⬛⬜⬜
⬜⬛⬛⬜⬜⬛⬛⬜⬛⬜⬛⬜⬛⬜⬛⬛⬛⬛⬜⬜⬛⬜⬜⬛⬜⬛⬛⬜⬜⬜⬜⬛⬛⬜⬜⬜⬛⬜⬜⬛⬜⬛⬜⬛⬜⬛⬛⬛⬛⬜⬜⬜⬛⬛⬜
⬜⬜⬛⬛⬛⬜⬜⬛⬛⬜⬛⬛⬛⬛⬛⬜⬜⬛⬛⬛⬜⬛⬛⬛⬜⬛⬛⬛⬛⬛⬛⬛⬛⬛⬛⬛⬜⬛⬛⬛⬜⬛⬜⬛⬜⬜⬜⬜⬛⬛⬛⬛⬜⬜⬜
⬜⬛⬛⬜⬛⬛⬛⬛⬜⬛⬛⬜⬜⬛⬛⬜⬛⬜⬛⬜⬜⬛⬛⬜⬛⬜⬛⬜⬛⬜⬜⬜⬛⬜⬜⬜⬛⬛⬜⬛⬛⬛⬛⬛⬛⬛⬛⬜⬛⬜⬛⬛⬛⬛⬜
⬜⬜⬛⬜⬛⬛⬛⬜⬛⬜⬛⬛⬜⬛⬛⬛⬜⬛⬛⬛⬛⬛⬜⬜⬛⬜⬛⬛⬜⬛⬛⬛⬜⬛⬛⬛⬛⬛⬜⬛⬜⬛⬜⬜⬛⬜⬛⬛⬜⬛⬜⬜⬜⬛⬜
⬜⬛⬛⬜⬛⬛⬛⬜⬛⬜⬛⬜⬛⬛⬛⬛⬛⬛⬛⬛⬜⬜⬛⬛⬛⬜⬛⬛⬛⬜⬜⬛⬜⬛⬜⬛⬜⬛⬜⬛⬜⬛⬛⬛⬛⬜⬛⬛⬜⬛⬛⬛⬛⬜⬜
⬜⬜⬛⬜⬛⬜⬛⬛⬛⬜⬛⬜⬛⬛⬛⬛⬛⬜⬛⬛⬛⬜⬜⬜⬛⬛⬜⬛⬜⬛⬜⬜⬛⬛⬛⬜⬛⬛⬛⬛⬛⬜⬛⬜⬛⬛⬜⬛⬜⬛⬜⬛⬜⬜⬜
⬜⬜⬛⬜⬛⬜⬜⬜⬛⬜⬜⬜⬛⬛⬜⬜⬛⬜⬜⬛⬛⬛⬛⬛⬜⬛⬜⬛⬜⬛⬛⬛⬛⬛⬛⬛⬜⬜⬜⬜⬜⬛⬜⬛⬛⬜⬜⬛⬛⬜⬛⬛⬛⬜⬜
⬜⬛⬛⬜⬛⬛⬛⬛⬜⬛⬛⬛⬜⬜⬛⬛⬜⬛⬛⬛⬜⬛⬛⬛⬛⬛⬜⬛⬜⬜⬜⬛⬛⬛⬛⬛⬛⬛⬛⬛⬜⬛⬜⬛⬜⬛⬜⬛⬛⬛⬜⬛⬛⬛⬜
⬜⬜⬜⬛⬛⬜⬜⬛⬜⬛⬜⬜⬛⬛⬜⬛⬜⬛⬛⬛⬜⬜⬛⬜⬜⬛⬛⬜⬛⬛⬛⬛⬛⬜⬜⬛⬛⬛⬜⬜⬛⬛⬜⬜⬛⬛⬛⬛⬛⬜⬛⬜⬛⬜⬜
⬜⬛⬛⬜⬜⬛⬛⬛⬛⬛⬜⬛⬜⬛⬜⬛⬜⬜⬜⬜⬛⬛⬛⬛⬜⬛⬛⬜⬛⬜⬛⬜⬜⬛⬛⬛⬛⬛⬛⬛⬛⬛⬛⬛⬛⬛⬛⬛⬜⬜⬛⬛⬛⬛⬜
⬜⬛⬜⬛⬛⬜⬜⬛⬛⬛⬛⬛⬜⬛⬜⬛⬛⬛⬛⬛⬜⬜⬜⬛⬜⬛⬛⬜⬛⬜⬛⬛⬛⬜⬜⬛⬛⬜⬜⬜⬜⬛⬛⬛⬛⬛⬛⬜⬛⬛⬜⬛⬛⬛⬜
⬜⬛⬜⬜⬜⬜⬛⬛⬜⬛⬜⬛⬜⬛⬜⬜⬛⬜⬜⬛⬜⬛⬜⬛⬜⬛⬜⬜⬛⬛⬛⬜⬛⬛⬛⬜⬜⬛⬛⬛⬛⬜⬜⬛⬛⬜⬜⬛⬜⬜⬜⬛⬛⬛⬜
⬜⬛⬜⬛⬛⬛⬜⬜⬜⬛⬜⬜⬜⬛⬛⬜⬛⬜⬜⬜⬛⬛⬛⬛⬜⬛⬛⬛⬜⬜⬛⬜⬛⬜⬜⬛⬜⬜⬜⬜⬛⬛⬜⬛⬛⬛⬜⬛⬛⬛⬛⬛⬛⬛⬜
⬜⬛⬜⬛⬜⬜⬛⬛⬛⬜⬛⬛⬛⬜⬛⬜⬛⬛⬛⬛⬛⬜⬜⬛⬛⬛⬜⬛⬛⬛⬛⬜⬛⬛⬛⬛⬛⬛⬛⬛⬜⬜⬛⬛⬜⬛⬛⬛⬜⬜⬜⬜⬜⬜⬜
⬜⬜⬛⬜⬛⬜⬛⬜⬛⬜⬛⬜⬛⬛⬛⬛⬛⬛⬜⬜⬛⬜⬛⬜⬛⬜⬛⬜⬜⬜⬜⬜⬛⬛⬛⬜⬛⬜⬜⬛⬛⬜⬜⬜⬛⬛⬜⬜⬛⬛⬛⬛⬛⬛⬜
⬜⬛⬜⬛⬜⬛⬛⬜⬛⬛⬛⬛⬜⬜⬛⬜⬛⬜⬛⬛⬛⬜⬛⬜⬛⬜⬛⬛⬛⬜⬛⬛⬛⬛⬛⬜⬜⬛⬛⬜⬛⬛⬛⬛⬜⬜⬛⬛⬜⬜⬛⬜⬛⬜⬜
⬜⬛⬜⬛⬜⬛⬜⬛⬜⬜⬜⬛⬛⬜⬜⬜⬛⬛⬜⬛⬛⬛⬜⬛⬛⬛⬜⬛⬜⬛⬛⬜⬜⬜⬛⬛⬛⬛⬜⬜⬛⬛⬛⬜⬜⬛⬜⬜⬛⬜⬛⬛⬜⬜⬜
⬜⬛⬛⬜⬜⬛⬛⬜⬛⬛⬛⬛⬜⬛⬛⬛⬜⬜⬛⬜⬛⬛⬛⬜⬜⬛⬛⬜⬛⬜⬜⬛⬛⬛⬜⬜⬜⬛⬛⬛⬜⬛⬛⬛⬛⬛⬜⬛⬛⬛⬜⬛⬛⬛⬜
⬜⬛⬛⬛⬛⬜⬜⬜⬛⬜⬛⬛⬛⬛⬛⬛⬛⬛⬛⬜⬛⬜⬜⬜⬛⬜⬛⬜⬛⬛⬛⬛⬛⬜⬛⬛⬛⬜⬛⬛⬜⬛⬜⬜⬛⬛⬜⬛⬜⬛⬜⬛⬜⬜⬜
⬜⬛⬛⬛⬜⬜⬛⬛⬜⬜⬛⬜⬜⬜⬛⬛⬜⬜⬜⬛⬜⬛⬛⬛⬛⬜⬛⬛⬜⬛⬜⬛⬛⬜⬛⬛⬛⬛⬜⬛⬛⬜⬛⬜⬜⬛⬜⬛⬜⬜⬛⬜⬛⬜⬜
⬜⬛⬛⬛⬛⬜⬛⬛⬛⬛⬜⬛⬛⬜⬛⬛⬛⬛⬛⬛⬜⬛⬜⬜⬛⬛⬛⬛⬛⬛⬜⬛⬛⬜⬜⬛⬛⬜⬛⬜⬛⬛⬛⬛⬜⬛⬜⬜⬛⬛⬛⬛⬜⬛⬜
⬜⬛⬛⬛⬛⬛⬛⬛⬜⬜⬛⬜⬛⬛⬛⬜⬜⬜⬜⬜⬜⬛⬛⬛⬜⬜⬛⬜⬜⬛⬜⬜⬛⬜⬛⬛⬜⬛⬛⬜⬛⬜⬛⬛⬛⬛⬛⬜⬛⬜⬛⬛⬛⬜⬜
⬜⬛⬛⬛⬛⬛⬛⬜⬛⬛⬛⬜⬛⬜⬜⬛⬛⬛⬛⬛⬛⬛⬛⬜⬛⬜⬛⬛⬛⬜⬛⬜⬛⬛⬛⬛⬜⬛⬛⬜⬛⬜⬛⬛⬛⬛⬛⬜⬜⬛⬜⬜⬜⬛⬜
⬜⬛⬛⬛⬛*️⃣⬛⬛⬜⬜⬜⬛⬜⬛⬛⬛⬛⬛⬛⬛⬜⬜⬜⬜⬛⬜⬛⬜⬜⬛⬛⬛⬛⬛⬛⬛⬜⬛⬜⬛⬜⬛⬛⬜⬛⬛⬛⬛⬜⬛⬜⬛⬛⬜⬜
⬜⬛⬛⬛⬛⬛⬛⬜⬛⬛⬛⬛⬛⬛⬛⬜⬜⬜⬛⬜⬛⬜⬛⬛⬛⬛⬛⬛⬜⬛⬜⬛⬜⬛⬛⬜⬛⬛⬛⬛⬜⬛⬛⬜⬛⬛⬛⬜⬜⬛⬛⬜⬜⬛⬜
⬜⬛⬜⬛⬜⬜⬛⬜⬜⬜⬛⬜⬜⬜⬜⬛⬛⬛⬛⬛⬛⬜⬛⬜⬜⬜⬜⬛⬜⬛⬜⬛⬛⬜⬜⬜⬛⬜⬜⬛⬜⬛⬜⬛⬜⬜⬛⬛⬛⬛⬛⬛⬜⬛⬜
⬜⬜⬛⬛⬛⬛⬜⬛⬛⬛⬜⬛⬛⬛⬜⬛⬜⬜⬜⬜⬛⬛⬛⬜⬛⬛⬜⬛⬜⬜⬛⬜⬜⬛⬛⬛⬛⬛⬛⬜⬜⬛⬜⬜⬛⬜⬜⬛⬛⬛⬜⬜⬛⬛⬜
⬜⬜⬜⬜⬜⬜⬛⬛⬜⬜⬛⬛⬛⬜⬛⬛⬛⬛⬛⬛⬛⬜⬛⬜⬜⬛⬜⬛⬛⬜⬛⬛⬛⬛⬜⬜⬛⬜⬛⬛⬜⬛⬛⬜⬛⬛⬛⬛⬛⬜⬛⬛⬜⬜⬜
⬜⬛⬛⬛⬛⬜⬛⬜⬛⬛⬛⬜⬛⬛⬜⬜⬛⬜⬛⬜⬜⬜⬛⬜⬛⬜⬛⬜⬜⬜⬛⬛⬛⬛⬛⬛⬛⬛⬜⬛⬜⬛⬛⬛⬜⬜⬛⬛⬛⬜⬛⬛⬛⬛⬜
⬜⬛⬛⬛⬜⬛⬜⬜⬛⬛⬜⬛⬜⬛⬛⬛⬛⬜⬛⬛⬛⬜⬛⬛⬜⬛⬜⬛⬛⬛⬛⬛⬛⬛⬛⬜⬜⬜⬛⬛⬛⬛⬜⬛⬛⬛⬛⬛⬛⬜⬛⬜⬛⬜⬜
⬜⬛⬛⬛⬜⬛⬛⬜⬜⬜⬛⬛⬜⬛⬜⬜⬜⬜⬛⬜⬛⬜⬛⬜⬜⬛⬜⬜⬜⬛⬛⬜⬜⬜⬜⬜⬛⬛⬜⬜⬛⬜⬛⬜⬛⬜⬜⬜⬛⬜⬛⬜⬛⬛⬜
⬜⬜⬛⬜⬛⬛⬜⬛⬛⬛⬛⬜⬛⬛⬜⬛⬛⬛⬜⬛⬛⬜⬛⬜⬛⬜⬛⬛⬛⬛⬜⬛⬛⬛⬛⬛⬛⬛⬜⬛⬛⬜⬛⬜⬛⬛⬛⬛⬜⬛⬜⬜⬜⬜⬜
⬜⬜⬛⬜⬛⬛⬜⬜⬜⬛⬛⬛⬜⬛⬛⬜⬜⬛⬜⬜⬛⬜⬛⬜⬛⬛⬜⬜⬜⬛⬜⬛⬛⬜⬜⬜⬜⬜⬛⬜⬜⬛⬜⬛⬛⬛⬜⬛⬛⬛⬛⬛⬛⬛⬜
⬜⬛⬛⬜⬛⬜⬛⬛⬛⬛⬜⬛⬜⬛⬛⬛⬜⬛⬛⬛⬛⬛⬛⬜⬜⬛⬛⬛⬛⬛⬛⬛⬛⬛⬛⬜⬛⬜⬜⬛⬜⬛⬜⬛⬛⬛⬜⬛⬛⬛⬜⬜⬛⬜⬜
⬜⬜⬛⬜⬜⬛⬜⬜⬜⬜⬜⬛⬛⬜⬜⬛⬛⬛⬜⬛⬜⬜⬛⬛⬜⬛⬛⬜⬜⬛⬜⬜⬜⬜⬛⬜⬛⬛⬛⭐⬜⬛⬜⬛⬛⬛⬛⬛⬛⬛⬛⬛⬛⬛⬜
⬜⬜⬛⬛⬛⬜⬛⬛⬛⬛⬛⬛⬜⬛⬛⬛⬜⬜⬛⬜⬛⬛⬛⬛⬛⬜⬛⬛⬜⬛⬛⬛⬛⬛⬜⬜⬛⬛⬛⬜⬜⬛⬜⬜⬛⬛⬛⬜⬛⬛⬜⬛⬜⬛⬜
⬜⬛⬛⬜⬜⬛⬛⬜⬜⬜⬜⬛⬜⬛⬜⬜⬛⬛⬛⬛⬜⬛⬜⬜⬛⬛⬛⬜⬜⬛⬜⬜⬛⬛⬛⬛⬛⬜⬛⬜⬛⬜⬜⬛⬛⬛⬜⬜⬛⬛⬛⬜⬛⬛⬜
⬜⬛⬜⬛⬛⬜⬛⬛⬛⬛⬜⬛⬜⬛⬛⬛⬛⬛⬜⬛⬜⬛⬛⬛⬛⬛⬛⬜⬛⬜⬛⬛⬜⬜⬜⬜⬜⬛⬜⬛⬛⬛⬛⬛⬛⬜⬜⬛⬜⬜⬛⬛⬛⬛⬜
⬜⬜⬜⬛⬜⬜⬛⬜⬜⬛⬛⬛⬜⬛⬜⬜⬛⬜⬛⬛⬛⬛⬜⬛⬛⬛⬛⬜⬛⬛⬜⬛⬜⬛⬜⬛⬛⬛⬛⬜⬜⬜⬜⬜⬜⬜⬛⬛⬜⬛⬜⬜⬜⬜⬜
⬜⬛⬜⬜⬜⬛⬜⬛⬛⬜⬜⬜⬛⬛⬜⬛⬛⬛⬜⬛⬛⬛⬜⬜⬛⬛⬛⬛⬜⬛⬛⬛⬜⬛⬜⬛⬛⬛⬛⬜⬛⬛⬛⬛⬛⬛⬜⬛⬜⬛⬛⬛⬛⬛⬜
⬜⬜⬛⬛⬛⬜⬛⬛⬛⬛⬛⬜⬛⬛⬛⬜⬛⬜⬛⬜⬜⬜⬛⬜⬜⬛⬛⬛⬛⬜⬜⬛⬛⬛⬛⬛⬛⬜⬛⬜⬛⬛⬜⬛⬜⬜⬜⬛⬜⬛⬜⬛⬜⬛⬜
⬜⬜⬛⬛⬛⬛⬜⬛⬛⬛⬛⬜⬛⬜⬛⬜⬛⬜⬛⬛⬛⬛⬜⬛⬛⬜⬛⬛⬛⬛⬜⬛⬛⬛⬜⬜⬜⬜⬛⬛⬛⬛⬜⬛⬜⬛⬛⬜⬛⬛⬜⬛⬜⬛⬜
⬜⬛⬛⬜⬜⬛⬛⬜⬛⬛⬛⬜⬛⬛⬜⬛⬛⬛⬜⬜⬜⬜⬛⬜⬛⬜⬛⬛⬛⬛⬛⬛⬛⬜⬛⬛⬛⬛⬛⬜⬜⬛⬛⬛⬛⬛⬛⬜⬛⬜⬜⬛⬜⬛⬜
⬜⬜⬛⬛⬜⬛⬛⬛⬜⬛⬜⬛⬛⬜⬛⬛⬜⬛⬛⬛⬛⬜⬛⬜⬛⬜⬜⬛⬜⬛⬛⬛⬜⬜⬛⬜⬛⬜⬛⬜⬛⬜⬛⬛⬛⬛⬛⬛⬛⬛⬛⬛⬜⬛⬜
⬜⬛⬛⬛⬜⬜⬜⬜⬜⬛⬜⬛⬜⬜⬛⬛⬜⬛⬛⬜⬛⬜⬛⬜⬛⬛⬜⬛⬜⬛⬛⬜⬜⬛⬛⬜⬜⬛⬛⬛⬛⬜⬛⬛⬛⬜⬜⬛⬛⬜⬛⬛⬛⬛⬜
⬜⬜⬜⬜⬛⬜⬛⬛⬛⬛⬜⬛⬛⬛⬜⬜⬛⬛⬜⬜⬛⬛⬛⬜⬛⬜⬜⬛⬜⬛⬛⬛⬜⬛⬜⬜⬛⬛⬛⬜⬛⬜⬛⬛⬛⬛⬛⬛⬜⬛⬛⬛⬛⬛⬜
⬜⬜⬜⬜⬜⬜⬜⬜⬜⬜⬜⬜⬜⬜⬜⬜⬜⬜⬜⬜⬜⬜⬜⬜⬜⬜⬜⬜⬜⬜⬜⬜⬜⬜⬜⬜⬜⬜⬜⬜⬜⬜⬜⬜⬜⬜⬜⬜⬜⬜⬜⬜⬜⬜⬜
