⬜⬜⬜⬜⬜⬜⬜⬜⬜⬜⬜⬜⬜⬜⬜⬜⬜⬜⬜⬜⬜⬜⬜⬜⬜⬜⬜⬜⬜⬜⬜⬜⬜⬜⬜⬜⬜⬜⬜⬜⬜⬜⬜⬜⬜⬜⬜⬜⬜⬜⬜⬜⬜⬜⬜
⬜⬜⬛⬛⬜⬛⬜⬜⬛⬜⬛⬜⬛⬜⬛⬜⬛⬜⬜⬛⬜⬛⬜⬜⬛⬜⬜⬜⬛⬛⬛⬜⬜⬛⬛⬛⬛⬛⬛⬜⬜⬛⬛⬛⬜⬛⬜⬜⬛⬛⬛⬛⬛⬜⬜
⬜⬜⬛⬛⬜⬛⬜⬛⬛⬛⬛⬛⬜⬛⬜⬛⬛⬛⬜⬛⬛⬛⬛⬛⬛⬛⬛⬛⬛⬛⬜⬛⬛⬜⬜⬜⬛⬜⬜⬛⬛⬛⬛⬛⬜⬜⬛⬛⬛⬛⬛⬛⬛⬛⬜
⬜⬛⬜⬛⬜⬛⬜⬛⬜⬜⬜⬜⬜⬛⬛⬛⬛⬜⬛⬜⬛*️⃣⬛⬜⬜⬛⬜⬜⬛⬜⬛⬛⬛⬛⬛⬛⬛⬜⬛⬜⬛⬜⬜⬛⬛⬛⬜⬛⬜⬛⬜⬜⬜⬛⬜
⬜⬛⬛⬜⬜⬛⬛⬛⬛⬛⬛⬛⬛⬛⬜⬜⬜⬜⬛⬛⬛⬛⬛⬛⬛⬜⬛⬛⬛⬜⬛⬛⬛⬜⬜⬛⬛⬛⬛⬜⬛⬛⬛⬛⬜⬛⬜⬛⬛⬜⬛⬛⬛⬜⬜
⬜⬛⬛⬛⬛⬛⬜⬜⬜⬛⬛⬛⬛⬛⬜⬛⬛⬛⬛⬛⬛⬜⬜⬛⬛⬛⬛⬜⬛⬜⬜⬜⬜⬛⬜⬜⬛⬜⬛⬜⬛⬜⬜⬛⬜⬛⬛⬛⬛⬛⬛⬜⬜⬛⬜
⬜⬛⬛⬜⬜⬜⬛⬛⬛⬛⬛⬜⬜⬛⬜⬜⬜⬛⬜⬛⬛⬜⬛⬜⬛⬜⬛⬜⬛⬛⬛⬛⬜⬛⬛⬛⬜⬜⬛⬜⬛⬜⬜⬛⬛⬛⬜⬜⬛⬛⬜⬛⬜⬛⬜
⬜⬛⬜⬛⬛⬛⬛⬛⬜⬜⬛⬜⬜⬛⬛⬛⬜⬛⬜⬛⬛⬛⬛⬜⬛⬜⬛⬛⬛⬛⬛⬛⬛⬛⬛⬛⬛⬜⬛⬜⬛⬛⬜⬛⬜⬛⬛⬛⬜⬛⬜⬜⬛⬛⬜
⬜⬛⬜⬛⬜⬛⬜⬛⬜⬛⬛⬛⬛⬜⬜⬛⬜⬛⬜⬜⬜⬛⬛⬛⬛⬛⬜⬛⬛⬛⬜⬜⬜⬜⬜⬜⬛⬜⬛⬜⬜⬛⬛⬛⬛⬜⬛⬜⬜⬛⬛⬜⬛⬜⬜
⬜⬛⬜⬛⬛⬜⬛⬛⬛⬜⬜⬛⬛⬛⬛⬛⬜⬛⬛⬛⬛⬜⬜⬜⬜⬛⬜⬛⬛⬜⬛⬜⬛⬛⬛⬜⬜⬛⬜⬛⬛⬜⬛⬜⬛⬜⬛⬜⬛⬜⬛⬜⬛⬜⬜
⬜⬜⬜⬛⬛⬜⬛⬜⬜⬜⬛⬜⬛⬛⬛⬜⬜⬛⬜⬜⬛⬛⬛⬛⬛⬛⬛⬛⬜⬛⬛⬜⬛⬜⬜⬛⬛⬜⬛⬜⬜⬛⬜⬜⬛⬜⬛⬛⬛⬜⬛⬛⬛⬛⬜
⬜⬛⬜⬛⬜⬜⬛⬜⬛⬛⬛⬜⬛⬛⬛⬛⬛⬛⬛⬛⬜⬛⬜⬛⬛⬛⬛⬛⬛⬜⬛⬜⬜⬛⬛⬛⬛⬜⬛⬜⬛⬛⬜⬛⬛⬛⬜⬛⬛⬜⬜⬛⬛⬛⬜
⬜⬛⬛⬛⬛⬛⬛⬛⬛⬛⬜⬜⬜⬜⬜⬛⬛⬜⬜⬛⬜⬜⬛⬜⬛⬛⬛⬛⬛⬜⬛⬛⬛⬜⬜⬜⬛⬛⬛⬜⬛⬛⬜⬛⬜⬛⬛⬛⬜⬜⬛⬜⬛⬜⬜
⬜⬜⬛⬛⬛⬛⬜⬜⬛⬜⬜⬛⬛⬛⬜⬛⬜⬛⬜⬛⬜⬛⬛⬜⬛⬛⬛⬛⬛⬛⬜⬜⬛⬛⬛⬛⬜⬛⬛⬜⬛⬜⬛⬛⬜⬛⬜⬜⬛⬜⬛⬛⬛⬛⬜
⬜⬛⬜⬛⬛⬛⬜⬛⬜⬛⬛⬛⬜⬜⬛⬜⬛⬜⬛⬜⬛⬛⬛⬜⬜⬜⬛⬜⬜⬛⬛⬛⬜⬜⬜⬜⬜⬛⬛⬛⬛⬜⬛⬛⬜⬛⬛⬛⬜⬛⬜⬜⬜⬜⬜
⬜⬛⬜⬜⬜⬛⬜⬛⬜⬜⬜⬜⬛⬜⬛⬜⬛⬛⬛⬜⬜⬜⬜⬛⬛⬛⬛⬜⬛⬛⬜⬛⬛⬛⬛⬛⬛⬛⬛⬛⬛⬜⬛⬜⬛⬜⬛⬛⬛⬛⬛⬛⬛⬜⬜
⬜⬛⬛⬛⬛⬛⬜⬛⬛⬛⬛⬜⬛⬛⬛⬜⬜⬜⬛⬛⬛⬜⬛⬛⬜⬜⬜⬛⬛⬜⬛⬜⬛⬜⬜⬜⬜⬜⬛⬛⬛⬜⬛⬜⬛⬜⬛⬛⬛⬜⬛⬜⬜⬛⬜
⬜⬛⬛⬛⬜⬜⬛⬛⬜⬜⬛⬛⬜⬜⬜⬛⬛⬛⬜⬛⬛⬛⬛⬛⬛⬛⬛⬜⬜⬜⬛⬛⬛⬛⬛⬛⬛⬛⬜⬛⬛⬛⬜⬛⬛⬜⬜⬛⬛⬜⬛⬛⬜⬛⬜
⬜⬛⬛⬛⬜⬛⬛⬜⬛⬛⬛⬜⬛⬛⬛⬛⬜⬜⬜⬛⬛⬛⬛⬜⬜⬛⬜⬛⬛⬛⬛⬜⬜⬛⬜⬜⬜⬛⬜⬛⬛⬛⬜⬜⬜⬛⬛⬛⬛⬜⬛⬛⬛⬛⬜
⬜⬛⬛⬛⬛⬛⬜⬛⬛⬜⬜⬛⬛⬜⬛⬛⬛⬛⬛⬛⬛⬜⬜⬜⬛⬜⬛⬛⬛⬜⬛⬜⬛⬛⬛⬛⬛⬜⬛⬛⬛⬛⬛⬛⬛⬜⬜⬛⬛⬜⬛⬜⬛⬜⬜
⬜⬜⬜⬜⬜⬛⬜⬛⬛⬛⬛⬛⬜⬛⬜⬜⬛⬛⬜⬜⬛⬜⬛⬛⬛⬜⬛⬜⬛⬜⬛⬛⬜⬛⬛⬛⬜⬛⬜⬜⬜⬛⬜⬜⬛⬛⬜⬛⬜⬜⬜⬜⬜⬛⬜
⬜⬜⬛⬜⬛⬛⬛⬜⬜⬜⬜⬛⬜⬛⬛⬜⬜⬛⬜⬛⬛⬜⬜⬜⬛⬛⬛⬜⬛⬜⬛⬛⬜⬛⬜⬜⬛⬛⬛⬛⬛⬛⬛⬜⬛⬜⬛⬜⬛⬛⬛⬛⬛⬜⬜
⬜⬜⬛⬜⬛⬜⬜⬛⬛⬛⬜⬛⬜⬛⬛⬜⬛⬛⬛⬜⬛⬛⬛⬛⬜⬛⬜⬛⬛⬜⬛⬛⬛⬛⬛⬛⬜⬛⬛⬛⬜⬜⬜⬜⬛⬜⬛⬛⬜⬛⬛⬜⬛⬛⬜
⬜⬛⬜⬛⬜⬛⬛⬛⬜⬛⬛⬛⬜⬜⬜⬜⬛⬜⬛⬜⬛⬛⬜⬛⬜⬛⬛⬛⬜⬛⬜⬜⬜⬛⬜⬜⬛⬜⬛⬛⬜⬛⬜⬛⬜⬜⬛⬜⬛⬛⬛⬜⬛⬛⬜
⬜⬛⬜⬛⬛⬛⬛⬛⬛⬜⬜⬜⬛⬛⬛⬛⬛⬜⬛⬜⬛⬛⬛⬜⬛⬜⬛⬛⬜⬛⬜⬛⬜⬛⬛⬜⬜⬜⬛⬜⬛⬛⬛⬛⬛⬜⬛⬛⬛⬜⬛⬛⬜⬜⬜
⬜⬛⬜⬛⬜⬛⬜⬜⬛⬛⬛⬛⬜⬛⬛⬜⬜⬜⬛⬜⬛⬜⬛⬜⬛⬛⬜⬛⬜⬛⬜⬛⬜⬜⬛⬛⬛⬛⬛⬛⬜⬛⬛⬛⬜⬜⬛⬛⬛⬜⬛⬜⬛⬛⬜
⬜⬛⬛⬛⬛⬜⬛⬜⬛⬛⬜⬜⬛⬛⬛⬛⬛⬛⬛⬜⬛⬜⬛⬜⬜⬛⬜⬛⬜⬛⬜⬛⬛⬛⬛⬛⬛⬜⬜⬜⬛⬜⬜⬛⬜⬛⬜⬛⬜⬜⬛⬛⬛⬜⬜
⬜⬛⬛⬜⬛⬜⬛⬛⬛⬜⬛⬜⬜⬜⬜⬜⬜⬛⬜⬛⬛⬜⬛⬜⬛⬛⬜⬛⬛⬛⬛⬛⬜⬜⬛⬛⬛⬛⬜⬛⬜⬛⬛⬛⬜⬛⬜⬛⬛⬛⬛⬜⬜⬜⬜
⬜⬜⬜⬜⬛⬛⬛⬜⬜⬜⬛⬛⬛⬛⬛⬛⬛⬛⬛⬛⬛⬛⬛⬜⬛⬛⬛⬛⬜⬜⬜⬛⬛⬜⬛⬛⬜⬛⬛⬜⬛⬜⬛⬜⬛⬛⬛⬛⬜⬜⬜⬛⬛⬛⬜
⬜⬛⬛⬛⬜⬜⬛⬛⬛⬛⬜⬛⬜⬛⬜⬜⬛⬛⬜⬜⬜⬜⬛⬛⬜⬛⬛⬛⬜⬛⬜⬜⬛⬜⬛⬜⬜⬜⬛⬜⬛⬜⬛⬜⬛⬜⬛⬜⬛⬛⬜⬛⬛⬜⬜
⬜⬛⬜⬜⬜⬛⬜⬛⬜⬛⬛⬜⬜⬛⬜⬛⬜⬛⬛⬛⬛⬛⬜⬛⬛⬛⬛⬜⬛⬛⬜⬛⬜⬜⬛⬜⬛⬛⬜⬜⬛⬜⬛⬜⬛⬜⬛⬛⬛⬜⬛⬛⬛⬛⬜
⬜⬛⬜⬛⬛⬜⬛⬜⬛⬜⬛⬛⬛⬛⬜⬛⬜⬜⬜⬜⬛⬛⬜⬛⬜⬜⬜⬛⬜⬛⬛⬛⬜⬛⬛⬛⬜⬛⬛⬜⬜⬛⬛⬛⬜⬛⬛⬜⬜⬛⬜⬜⬛⬛⬜
⬜⬜⬜⬛⬜⬛⬛⬛⬛⬜⬛⬜⬛⬜⬛⬛⬛⬛⬛⬛⬜⬛⬛⬛⬛⬛⬛⬛⬜⬛⬛⬛⬜⬛⬛⬛⬜⬛⬛⬛⬛⬜⬛⬛⬛⬛⬛⬛⬛⬛⬜⬛⬛⬜⬜
⬜⬛⬜⬜⬛⬜⬛⬜⬜⬜⬛⬜⬛⬜⬛⬜⬜⬛⬜⬜⬜⬛⬛⬛⬛⬛⬜⬛⬛⬛⬜⬜⬛⬜⬜⬜⬜⬜⬛⬜⬛⬜⬛⬛⬛⬜⬜⬛⬜⬛⬜⬜⬜⬜⬜
⬜⬛⬛⬛⬛⬜⬛⬛⬛⬛⬛⬛⬛⬜⬛⬜⬛⬜⬛⬜⬛⬛⬛⬛⬛⬛⬛⬜⬜⬜⬛⬜⬛⬜⬛⬛⬛⬜⬛⬛⬜⬜⬛⬜⬛⬛⬛⬜⬜⬛⬜⬛⬛⬛⬜
⬜⬛⬛⬛⬛⬜⬛⬜⬛⬛⬜⬛⬜⬜⬛⬜⬛⬛⬛⬜⬛⬛⬛⬛⬛⬛⬛⬜⬛⬛⬛⬛⬛⬜⬛⬛⬜⬛⬛⬛⬜⬛⬛⬜⬛⬜⬛⬜⬛⬛⬜⬜⬜⬛⬜
⬜⬜⬛⬜⬛⬛⬛⬜⬜⬛⬛⬜⬛⬛⬛⬛⬜⬛⬜⬛⬛⬛⬜⬛⬛⬛⬛⬜⬛⬜⬜⬜⬛⬜⬛⬛⬜⬛⬜⬛⬛⬛⬛⬜⬛⬜⬛⬜⬛⬛⬛⬛⬛⬛⬜
⬜⬜⬜⬜⬛⬛⬛⬛⬛⬜⬛⬜⬛⬛⬜⬛⬜⬛⬜⬜⬛⬜⬛⬛⬜⬛⬛⬜⬛⬛⬛⬛⬜⬜⬛⬜⬛⬛⬜⬜⬛⬛⬛⬜⬛⬛⬛⬛⬛⬜⬛⬜⬜⬛⬜
⬜⬛⬛⬛⬛⬛⬛⬛⬜⬜⬛⬜⬜⬛⬜⬛⬜⬛⬛⬛⬛⬜⬜⬜⬜⬛⬜⬛⬜⬛⬜⬛⬛⬛⬛⬛⬜⬜⬛⬜⬛⬛⬛⬜⬛⬜⬜⬜⬜⬜⬛⬜⬛⬛⬜
⬜⬛⬛⬜⬜⬜⬜⬛⬛⬛⬛⬛⬛⬛⬛⬛⬛⬛⬜⬜⬛⬜⬛⬛⬛⬜⬛⬜⬛⬛⬜⬜⬜⬜⬛⬜⬛⬛⬛⬜⬛⬛⬜⬛⬛⬛⬛⬛⬛⬛⬛⬛⬜⬛⬜
⬜⬛⬛⬛⬛⬛⬛⬜⬛⬜⬜⬜⬜⬛⬜⬜⬜⬛⬜⬛⬜⬛⬛⬛⬛⬜⬛⬛⬜⬛⬛⬛⬛⬛⬛⬜⬛⬛⬛⬜⬛⬛⬛⬜⬜⬜⬜⬜⬛⬜⬛⬛⬜⬜⬜
⬜⬜⬜⬜⬜⬛⬛⬛⬛⬛⬛⬛⬛⬜⬛⬛⬛⬛⬛⬛⬛⬜⬛⬛⬛⬛⬜⬛⬜⬛⬛⬛⬛⬜⬛⬛⬜⬛⬜⬛⬜⬛⬜⬛⬛⬜⬛⬜⬜⬛⬜⬜⬛⬛⬜
⬜⬛⬛⬜⬛⬜⬛⬛⬜⬛⬛⬛⬛⬛⬛⬜⬛⬜⬛⬜⬛⬛⬜⬜⬜⬛⬜⬛⬛⬛⬛⬜⬛⬜⬜⬛⬜⬜⬜⬛⬜⬛⬜⬜⬜⬛⬛⬜⬛⬛⬛⬛⬛⬜⬜
⬜⬛⬛⬛⬛⬜⬛⬜⬛⬛⬜⬛⬛⬜⬛⬜⬛⬜⬛⬛⬜⬛⬛⬛⬛⬛⬜⬛⬛⬜⬜⬛⬛⬛⬛⬛⬛⬛⬛⬛⬜⬛⬛⬛⬛⬛⬜⬜⬛⬛⬛⬜⬛⬜⬜
⬜⬜⬜⬜⬜⬛⬛⬛⬜⬛⬛⬜⬛⬜⬛⬜⬛⬜⬛⬜⬛⬛⬛⬛⬛⬛⬛⬛⬛⬛⬛⬛⬛⬛⬛⬛⬛⬜⬜⬛⬜⬛⬛⬛⬛⬜⬛⬛⬛⬛⬛⬜⬛⬜⬜
⬜⬛⬛⬛⬛⬜⬜⬜⬜⬜⬜⬜⬛⬜⬛⬜⬛⬛⬜⬜⬜⬜⬜⬛⬛⬜⬜⬜⬛⬛⬜⬜⬛⬜⬛⬛⬛⬜⬛⬛⬜⬛⬜⬛⬛⬛⬛⬜⬜⬛⬜⬜⬛⬜⬜
⬜⬜⬜⬜⬛⬛⬛⬛⬛⬛⬛⬛⬛⬛⬜⬛⬜⬛⬛⬛⬛⬛⬛⬛⬜⬛⬛⬜⬛⬛⬛⬜⬛⬜⬛⬛⬜⬛⬜⬛⬛⬜⬛⬜⬛⬛⬜⬛⬜⬛⬛⬜⬛⬛⬜
⬜⬛⬜⭐⬜⬜⬛⬜⬜⬛⬛⬛⬜⬛⬜⬜⬛⬜⬜⬜⬛⬜⬜⬛⬜⬛⬜⬛⬛⬛⬛⬛⬛⬜⬛⬜⬜⬛⬜⬛⬜⬜⬛⬜⬛⬜⬛⬛⬛⬛⬜⬜⬛⬛⬜
⬜⬛⬜⬛⬜⬛⬛⬛⬛⬜⬛⬛⬛⬜⬛⬛⬛⬛⬛⬛⬜⬜⬛⬛⬛⬛⬛⬜⬜⬜⬜⬜⬜⬜⬜⬛⬛⬛⬜⬛⬜⬛⬜⬛⬜⬜⬛⬜⬜⬜⬛⬛⬛⬛⬜
⬜⬜⬛⬜⬛⬜⬛⬜⬜⬜⬛⬛⬛⬜⬛⬜⬛⬜⬛⬛⬜⬛⬛⬜⬛⬜⬜⬛⬛⬛⬛⬛⬛⬜⬛⬛⬜⬛⬛⬛⬜⬜⬛⬛⬛⬛⬛⬜⬛⬛⬜⬛⬛⬛⬜
⬜⬜⬛⬜⬛⬜⬛⬛⬛⬛⬛⬜⬜⬜⬛⬜⬛⬛⬜⬛⬜⬜⬛⬜⬛⬜⬛⬛⬜⬜⬜⬜⬜⬛⬛⬛⬜⬜⬜⬜⬜⬛⬛⬜⬛⬜⬛⬛⬜⬜⬛⬛⬛⬜⬜
⬜⬛⬜⬜⬛⬛⬜⬜⬛⬜⬛⬜⬛⬛⬛⬛⬜⬛⬛⬜⬛⬜⬛⬛⬛⬛⬛⬜⬜⬛⬛⬛⬛⬜⬛⬛⬛⬛⬛⬛⬜⬛⬛⬜⬜⬛⬜⬛⬜⬛⬛⬛⬛⬛⬜
⬜⬛⬜⬛⬛⬛⬜⬛⬛⬜⬛⬜⬛⬜⬜⬛⬛⬜⬛⬜⬛⬛⬜⬜⬜⬛⬜⬛⬛⬛⬜⬜⬜⬜⬛⬜⬜⬜⬜⬜⬛⬛⬜⬛⬛⬛⬜⬛⬛⬜⬛⬛⬛⬛⬜
⬜⬛⬜⬛⬛⬜⬛⬜⬜⬜⬛⬜⬛⬛⬛⬛⬛⬜⬛⬛⬛⬛⬛⬛⬜⬛⬛⬜⬜⬜⬛⬛⬛⬜⬛⬛⬛⬛⬛⬜⬛⬜⬛⬜⬜⬜⬜⬜⬛⬛⬛⬛⬛⬛⬜
⬜⬜⬜⬜⬜⬜⬜⬜⬜⬜⬜⬜⬜⬜⬜⬜⬜⬜⬜⬜⬜⬜⬜⬜⬜⬜⬜⬜⬜⬜⬜⬜⬜⬜⬜⬜⬜⬜⬜⬜⬜⬜⬜⬜⬜⬜⬜⬜⬜⬜⬜⬜⬜⬜⬜
