⬜⬜⬜⬜⬜⬜⬜⬜⬜⬜⬜⬜⬜⬜⬜⬜⬜⬜⬜⬜⬜⬜⬜⬜⬜⬜⬜⬜⬜⬜⬜⬜⬜⬜⬜⬜⬜⬜⬜⬜⬜⬜⬜⬜⬜⬜⬜⬜⬜⬜⬜⬜⬜⬜⬜
⬜⬜⬛⬛⬛⬛⬛⬜⬜⬛⬛⬛⬛⬛⬜⬛⬜⬜⬛⬜⬛⬛⬜⬛⬛⬛⬜⬛⬜⬛⬜⬛⬜⬜⬛⬛⬛⬜⬛⬜⬛⬜⬜⬜⬛⬛⬛⬛⬜⬛⬛⬛⬛⬛⬜
⬜⬛⬜⬛⬛⬜⬜⬛⬛⬛⬜⬛⬜⬛⬛⬜⬛⬜⬛⬜⬜⬜⬜⬛⬜⬛⬛⬛⬜⬛⬛⬛⬛⬛⬛⬛⬛⬜⬛⬜⬛⬜⬛⬛⬜⬜⬜⬛⬜⬛⬛⬛⬜⬛⬜
⬜⬜⬛⬛⬛⬛⬜⬛⬜⬛⬜⬛⬜⬜⬜⬛⬛⬛⬛⬛⬛⬛⬛⬛⬜⬛⬛⬛⬜⬜⬛⬛⬜⬛⬛⬜⬛⬜⬛⬜⬛⬜⬜⬛⬛⬛⬛⬛⬛⬜⬜⬛⬜⬛⬜
⬜⬛⬛⬜⬛⬛⬜⬛⬜⬛⬛⬜⬛⬛⬛⬛⬛⬜⬜⬜⬛⬜⬜⬛⬛⬜⬛⬜⬛⬜⬛⬜⬜⬛⬜⬛⬜⬛⬛⬜⬛⬛⬛⬜⬛⬛⬛⬛⬛⬛⬛⬜⬛⬛⬜
⬜⬛⬜⬜⬜⬛⬛⬜⬛⬜⬜⬛⬜⬜⬜⬜⬜⬛⬛⬛⬛⬛⬛⬛⬜⬜⬛⬜⬛⬜⬛⬛⬜⬛⬛⬜⬜⬛⬛⬛⬛⬜⬜⬛⬛⬛⬛⬛⬜⬜⬛⬛⬛⬜⬜
⬜⬛⬛⬛⬛⬜⬛⬜⬛⬛⬜⬛⬜⬛⬛⬛⬜⬛⬜⬜⬜⬜⬜⬛⬜⬛⬛⬛⬛⬛⬛⬜⬛⬛⬛⬛⬛⬛⬜⬜⬜⬛⬜⬛⬜⬜⬜⬛⬛⬜⬛⬜⬜⬛⬜
⬜⬛⬛⬜⬜⬛⬛⬜⬜⬜⬛⬛⬛⬛⬜⬜⬜⬛⬜⬛⬛⬛⬜⬜⬜⬛⬜⬜⬛⬛⬛⬜⬜⬜⬛⬛⬜⬜⬛⬛⬛⬛⬜⬛⬛⬜⬛⬛⬛⬛⬜⬛⬜⬛⬜
⬜⬜⬜⬛⬛⬛⬛⬛⬛⬛⬜⬜⬛⬜⬛⬛⬛⬜⬛⬜⬜⬛⬛⬛⬛⬜⬜⬛⬛⬛⬜⬛⬛⬛⬛⬜⬛⬛⬛⬛⬛⬜⬜⬛⬛⬛⬛⬛⬜⬛⬛⬛⬜⬛⬜
⬜⬜⬛⬜⬛⬛⬛⬛⬛⬛⬛⬜⬛⬜⬛⬜⬛⬛⬛⬜⬜⬜⬜⬜⬛⬛⬛⬜⬛⬛⬜⬜⬛⬛⬜⬜⬛⬛⬛⬛⬛⬛⬛⬜⬜⬜⬜⬛⬜⬛⬜⬜⬛⬜⬜
⬜⭐⬛⬜⬛⬛⬛⬜⬛⬛⬛⬛⬛⬛⬛⬛⬜⬜⬛⬛⬛⬛⬛⬛⬛⬛⬛⬜⬜⬛⬛⬛⬛⬜⬛⬛⬛⬛*️⃣⬛⬛⬛⬜⬛⬛⬛⬛⬛⬛⬜⬛⬜⬜⬛⬜
⬜⬛⬜⬜⬛⬜⬛⬜⬛⬛⬜⬛⬛⬛⬛⬛⬛⬜⬛⬜⬜⬜⬜⬜⬛⬛⬛⬛⬛⬜⬜⬜⬜⬛⬛⬛⬛⬛⬛⬛⬛⬛⬜⬛⬛⬛⬜⬜⬜⬜⬛⬛⬛⬛⬜
⬜⬛⬛⬜⬛⬜⬛⬛⬜⬛⬜⬜⬛⬛⬛⬜⬜⬛⬛⬜⬛⬛⬛⬛⬛⬜⬜⬜⬛⬜⬛⬜⬛⬛⬛⬛⬜⬛⬜⬛⬛⬜⬛⬛⬛⬛⬜⬛⬛⬛⬛⬛⬛⬜⬜
⬜⬜⬛⬛⬛⬛⬜⬜⬛⬛⬛⬛⬛⬛⬛⬛⬜⬛⬛⬜⬛⬛⬜⬜⬛⬜⬛⬛⬛⬛⬜⬛⬛⬜⬛⬛⬜⬛⬜⬛⬛⬜⬛⬛⬜⬛⬛⬜⬛⬛⬛⬛⬜⬛⬜
⬜⬛⬛⬜⬜⬜⬜⬛⬛⬛⬜⬜⬜⬛⬜⬛⬛⬜⬛⬜⬛⬛⬛⬜⬛⬛⬜⬜⬛⬛⬜⬛⬜⬛⬜⬛⬜⬛⬛⬛⬜⬛⬜⬜⬛⬜⬛⬜⬜⬛⬛⬛⬜⬜⬜
⬜⬛⬛⬜⬛⬛⬛⬜⬜⬜⬛⬛⬛⬛⬜⬜⬛⬜⬛⬜⬛⬜⬛⬛⬜⬛⬛⬛⬜⬛⬜⬛⬛⬛⬜⬛⬜⬜⬛⬜⬜⬛⬛⬜⬛⬜⬛⬜⬛⬜⬜⬜⬛⬜⬜
⬜⬛⬛⬜⬛⬜⬜⬛⬜⬛⬜⬛⬜⬛⬛⬜⬛⬜⬛⬜⬛⬜⬜⬛⬛⬜⬛⬜⬜⬛⬜⬛⬜⬛⬜⬜⬜⬛⬜⬛⬛⬜⬜⬛⬜⬛⬛⬜⬛⬜⬛⬛⬛⬜⬜
⬜⬜⬛⬜⬛⬜⬛⬜⬛⬛⬛⬛⬜⬛⬛⬛⬜⬛⬜⬛⬜⬛⬛⬛⬜⬛⬛⬛⬛⬛⬜⬛⬜⬜⬛⬛⬛⬛⬜⬛⬜⬛⬛⬛⬛⬛⬛⬜⬛⬜⬛⬛⬜⬜⬜
⬜⬛⬜⬜⬜⬜⬛⬜⬛⬛⬛⬜⬛⬜⬛⬜⬜⬛⬜⬜⬛⬜⬜⬛⬜⬛⬜⬛⬛⬛⬜⬛⬜⬛⬛⬛⬛⬛⬜⬛⬜⬜⬜⬜⬛⬛⬛⬛⬜⬛⬜⬜⬜⬛⬜
⬜⬛⬜⬛⬛⬛⬛⬛⬛⬛⬛⬜⬛⬜⬛⬜⬛⬜⬛⬛⬛⬛⬜⬛⬜⬛⬜⬛⬛⬛⬛⬜⬛⬜⬜⬜⬛⬜⬛⬜⬛⬛⬛⬛⬜⬜⬜⬛⬜⬛⬜⬛⬛⬛⬜
⬜⬜⬛⬛⬜⬛⬜⬜⬛⬛⬛⬛⬛⬛⬜⬛⬛⬛⬜⬜⬜⬛⬜⬛⬜⬛⬜⬛⬜⬜⬜⬛⬛⬛⬛⬛⬜⬜⬜⬜⬛⬛⬛⬛⬛⬛⬛⬛⬜⬛⬛⬜⬜⬜⬜
⬜⬛⬛⬜⬛⬜⬛⬛⬛⬛⬛⬛⬛⬛⬛⬛⬜⬛⬜⬛⬛⬜⬛⬛⬛⬛⬜⬛⬛⬛⬜⬛⬜⬜⬜⬜⬛⬛⬛⬛⬛⬛⬛⬛⬛⬜⬜⬛⬜⬜⬛⬛⬛⬜⬜
⬜⬜⬛⬛⬛⬜⬛⬜⬛⬛⬛⬛⬛⬜⬛⬛⬜⬛⬛⬛⬛⬜⬛⬜⬜⬛⬜⬜⬛⬜⬜⬛⬜⬛⬛⬜⬛⬜⬜⬛⬛⬛⬛⬛⬜⬛⬛⬜⬛⬛⬛⬜⬜⬛⬜
⬜⬛⬜⬜⬜⬛⬛⬜⬜⬜⬜⬜⬜⬜⬛⬛⬜⬛⬛⬜⬛⬛⬛⬜⬛⬛⬛⬛⬛⬛⬛⬛⬛⬛⬜⬜⬛⬜⬛⬜⬛⬜⬛⬜⬜⬜⬛⬜⬛⬛⬜⬛⬛⬛⬜
⬜⬛⬛⬛⬛⬜⬜⬛⬛⬛⬛⬜⬛⬛⬜⬜⬛⬜⬜⬜⬛⬜⬜⬛⬜⬛⬜⬜⬜⬜⬜⬜⬛⬜⬛⬛⬛⬛⬛⬛⬛⬜⬛⬛⬛⬛⬛⬜⬛⬛⬛⬜⬛⬛⬜
⬜⬛⬜⬜⬜⬛⬛⬜⬜⬛⬛⬛⬜⬛⬛⬛⬛⬛⬛⬛⬛⬜⬛⬛⬜⬛⬛⬛⬛⬛⬛⬛⬛⬛⬜⬜⬜⬜⬜⬜⬛⬛⬛⬜⬛⬛⬛⬛⬜⬛⬜⬛⬜⬛⬜
⬜⬜⬛⬛⬜⬜⬛⬛⬛⬛⬛⬜⬛⬜⬛⬜⬜⬛⬛⬛⬜⬛⬛⬜⬛⬜⬜⬜⬜⬜⬜⬛⬛⬛⬛⬛⬛⬛⬛⬛⬜⬜⬜⬛⬜⬜⬜⬜⬜⬛⬜⬛⬜⬛⬜
⬜⬛⬜⬛⬜⬛⬛⬜⬛⬛⬛⬛⬛⬛⬛⬛⬛⬜⬛⬛⬛⬜⬛⬜⬛⬛⬛⬛⬛⬛⬜⬛⬜⬛⬛⬜⬛⬜⬜⬛⬛⬛⬛⬜⬛⬛⬛⬛⬛⬛⬜⬛⬜⬛⬜
⬜⬛⬜⬛⬜⬛⬛⬜⬜⬜⬜⬛⬛⬜⬜⬛⬛⬛⬜⬛⬛⬜⬛⬜⬜⬛⬜⬜⬜⬜⬛⬛⬜⬛⬛⬛⬜⬜⬛⬜⬛⬜⬛⬛⬜⬛⬜⬜⬛⬜⬜⬛⬜⬛⬜
⬜⬜⬜⬛⬛⬜⬛⬜⬛⬛⬜⬜⬛⬛⬜⬛⬜⬛⬜⬛⬜⬜⬛⬛⬛⬜⬛⬛⬛⬜⬛⬛⬛⬛⬜⬜⬛⬛⬛⬜⬛⬜⬛⬛⬜⬛⬜⬛⬛⬜⬛⬛⬜⬛⬜
⬜⬛⬜⬜⬛⬜⬛⬜⬛⬜⬛⬛⬜⬜⬛⬛⬜⬛⬜⬜⬛⬛⬛⬜⬛⬜⬛⬜⬜⬛⬛⬛⬛⬜⬜⬜⬛⬜⬜⬛⬛⬛⬜⬛⬜⬛⬛⬜⬜⬛⬛⬛⬛⬜⬜
⬜⬜⬛⬛⬛⬛⬜⬛⬜⬜⬛⬜⬛⬜⬜⬛⬛⬛⬛⬛⬛⬛⬛⬜⬛⬛⬛⬛⬛⬛⬛⬜⬛⬛⬛⬛⬛⬛⬛⬜⬛⬜⬜⬛⬛⬛⬜⬛⬛⬜⬜⬜⬛⬜⬜
⬜⬜⬛⬛⬛⬜⬜⬛⬛⬛⬛⬛⬛⬛⬛⬛⬛⬜⬜⬛⬜⬛⬜⬛⬜⬜⬛⬛⬜⬜⬜⬛⬛⬜⬜⬜⬜⬜⬛⬜⬛⬛⬜⬛⬜⬜⬛⬛⬜⬜⬛⬛⬛⬜⬜
⬜⬜⬛⬜⬛⬜⬛⬛⬛⬜⬛⬜⬛⬜⬜⬛⬛⬜⬛⬜⬛⬜⬜⬛⬛⬛⬜⬜⬛⬛⬛⬛⬛⬛⬜⬛⬜⬛⬛⬜⬛⬛⬜⬜⬛⬛⬜⬛⬛⬛⬜⬛⬛⬜⬜
⬜⬛⬜⬛⬛⬛⬛⬛⬛⬜⬛⬛⬜⬛⬜⬜⬛⬛⬜⬛⬜⬛⬛⬜⬜⬛⬛⬛⬛⬛⬛⬛⬛⬛⬜⬛⬛⬛⬛⬜⬜⬜⬛⬛⬛⬛⬜⬜⬜⬜⬛⬜⬛⬜⬜
⬜⬛⬜⬛⬛⬜⬜⬛⬛⬜⬜⬛⬜⬛⬛⬛⬛⬜⬛⬜⬜⬛⬛⬜⬛⬛⬛⬜⬛⬛⬛⬜⬛⬛⬜⬛⬛⬛⬜⬛⬜⬛⬜⬜⬜⬛⬛⬛⬛⬜⬛⬜⬛⬜⬜
⬜⬛⬛⬜⬛⬛⬛⬛⬛⬜⬛⬛⬜⬛⬜⬜⬜⬛⬛⬛⬜⬛⬜⬛⬛⬜⬜⬛⬜⬜⬜⬛⬛⬛⬛⬜⬛⬜⬜⬛⬛⬜⬛⬜⬛⬛⬛⬛⬛⬜⬛⬛⬛⬛⬜
⬜⬜⬛⬜⬛⬜⬜⬜⬛⬛⬜⬜⬛⬛⬛⬛⬛⬛⬛⬜⬜⬛⬜⬛⬜⬛⬛⬛⬛⬛⬛⬜⬜⬛⬛⬜⬛⬜⬛⬜⬜⬛⬛⬛⬛⬜⬜⬜⬛⬛⬛⬛⬛⬛⬜
⬜⬜⬛⬜⬛⬛⬛⬜⬛⬛⬛⬛⬛⬛⬛⬛⬜⬛⬛⬛⬜⬛⬜⬛⬜⬛⬜⬛⬜⬜⬛⬜⬛⬛⬛⬜⬛⬛⬜⬛⬛⬜⬛⬛⬛⬛⬛⬛⬜⬛⬜⬛⬛⬜⬜
⬜⬛⬛⬜⬛⬜⬛⬛⬛⬜⬜⬛⬜⬛⬛⬜⬜⬛⬛⬛⬜⬛⬜⬛⬜⬛⬜⬛⬜⬛⬛⬜⬛⬜⬛⬜⬛⬛⬜⬛⬜⬛⬜⬛⬛⬛⬜⬛⬛⬜⬛⬜⬛⬜⬜
⬜⬜⬜⬜⬛⬜⬛⬜⬛⬜⬛⬜⬛⬛⬛⬛⬛⬛⬛⬛⬛⬜⬛⬛⬜⬛⬛⬜⬜⬛⬜⬛⬛⬜⬛⬛⬛⬜⬛⬛⬜⬛⬜⬛⬛⬜⬛⬜⬛⬜⬛⬜⬛⬜⬜
⬜⬜⬛⬛⬜⬛⬛⬜⬛⬜⬛⬛⬛⬛⬜⬛⬜⬜⬜⬜⬜⬛⬛⬜⬛⬜⬛⬛⬜⬛⬛⬜⬜⬛⬜⬜⬜⬛⬜⬛⬜⬜⬛⬛⬜⬛⬛⬜⬛⬜⬛⬜⬛⬜⬜
⬜⬜⬛⬜⬛⬜⬛⬛⬜⬜⬜⬛⬛⬛⬜⬛⬛⬛⬛⬛⬛⬛⬜⬛⬛⬛⬜⬛⬜⬜⬛⬛⬛⬛⬛⬛⬜⬜⬛⬛⬜⬛⬛⬜⬛⬛⬜⬜⬛⬜⬛⬛⬛⬛⬜
⬜⬜⬛⬜⬛⬛⬜⬛⬛⬛⬛⬜⬜⬜⬜⬛⬜⬛⬛⬛⬛⬛⬛⬛⬜⬜⬜⬛⬛⬛⬜⬜⬛⬜⬜⬛⬜⬛⬛⬜⬛⬛⬛⬛⬛⬛⬜⬛⬛⬛⬜⬛⬜⬜⬜
⬜⬜⬛⬜⬛⬛⬛⬜⬜⬜⬛⬜⬛⬛⬛⬜⬜⬛⬛⬛⬛⬛⬜⬛⬛⬜⬛⬜⬜⬛⬛⬛⬜⬛⬛⬛⬛⬜⬜⬛⬜⬛⬛⬛⬛⬛⬛⬛⬛⬛⬜⬛⬜⬛⬜
⬜⬜⬛⬜⬛⬜⬜⬛⬛⬛⬛⬜⬛⬜⬛⬜⬛⬛⬛⬛⬛⬛⬜⬜⬛⬛⬛⬛⬛⬛⬛⬛⬛⬜⬜⬜⬛⬛⬜⬛⬛⬛⬜⬛⬜⬜⬜⬜⬜⬛⬜⬛⬜⬛⬜
⬜⬛⬛⬜⬛⬛⬜⬛⬛⬛⬜⬜⬛⬛⬜⬛⬜⬜⬜⬛⬜⬛⬛⬜⬛⬛⬜⬛⬛⬛⬛⬜⬛⬜⬛⬛⬛⬜⬛⬛⬜⬜⬜⬛⬜⬛⬛⬛⬛⬛⬛⬛⬛⬜⬜
⬜⬛⬛⬜⬛⬜⬜⬛⬛⬛⬛⬜⬜⬜⬜⬛⬛⬛⬛⬛⬜⬛⬛⬛⬜⬛⬜⬛⬛⬛⬛⬜⬛⬛⬜⬛⬜⬜⬛⬛⬛⬛⬛⬛⬛⬜⬛⬜⬜⬜⬜⬜⬛⬜⬜
⬜⬛⬛⬜⬛⬛⬛⬛⬛⬛⬛⬛⬛⬜⬛⬜⬜⬜⬜⬛⬜⬛⬛⬜⬜⬛⬛⬛⬛⬜⬛⬜⬜⬛⬜⬛⬜⬛⬛⬛⬛⬜⬜⬜⬜⬛⬜⬜⬛⬛⬜⬛⬛⬜⬜
⬜⬜⬛⬜⬜⬛⬜⬛⬜⬛⬛⬛⬛⬛⬜⬜⬛⬛⬜⬛⬜⬛⬜⬛⬜⬛⬜⬜⬛⬜⬛⬜⬛⬛⬜⬛⬜⬛⬛⬛⬛⬜⬛⬛⬜⬛⬜⬛⬛⬛⬜⬛⬛⬜⬜
⬜⬜⬛⬛⬛⬜⬜⬛⬛⬜⬛⬛⬛⬜⬛⬛⬛⬜⬜⬛⬛⬜⬜⬛⬜⬛⬛⬜⬛⬜⬛⬛⬜⬛⬜⬜⬛⬜⬜⬛⬛⬛⬜⬜⬜⬛⬛⬜⬛⬛⬜⬛⬜⬛⬜
⬜⬜⬜⬛⬛⬛⬛⬛⬛⬛⬜⬛⬛⬜⬛⬛⬛⬛⬜⬛⬜⬛⬛⬛⬜⬜⬜⬛⬜⬛⬛⬛⬜⬛⬛⬛⬛⬛⬛⬜⬛⬜⬛⬛⬛⬜⬜⬜⬛⬜⬛⬛⬛⬜⬜
⬜⬛⬛⬛⬛⬛⬜⬛⬜⬜⬛⬛⬜⬜⬜⬜⬜⬜⬜⬛⬜⬛⬜⬜⬛⬛⬜⬛⬛⬛⬛⬜⬛⬛⬜⬛⬛⬛⬛⬜⬛⬜⬜⬛⬛⬛⬛⬜⬛⬜⬜⬜⬛⬛⬜
⬜⬜⬛⬜⬛⬜⬜⬛⬛⬛⬛⬜⬛⬛⬛⬛⬜⬛⬛⬛⬜⬜⬛⬛⬜⬛⬛⬛⬛⬛⬛⬜⬜⬜⬛⬛⬛⬛⬛⬜⬛⬛⬛⬜⬛⬛⬜⬜⬛⬜⬛⬛⬛⬜⬜
⬜⬜⬜⬜⬜⬜⬜⬜⬜⬜⬜⬜⬜⬜⬜⬜⬜⬜⬜⬜⬜⬜⬜⬜⬜⬜⬜⬜⬜⬜⬜⬜⬜⬜⬜⬜⬜⬜⬜⬜⬜⬜⬜⬜⬜⬜⬜⬜⬜⬜⬜⬜⬜⬜⬜
