⬜⬜⬜⬜⬜⬜⬜⬜⬜⬜⬜⬜⬜⬜⬜⬜⬜⬜⬜⬜⬜⬜⬜⬜⬜⬜⬜⬜⬜⬜⬜⬜⬜⬜⬜⬜⬜⬜⬜⬜⬜⬜⬜⬜⬜⬜⬜⬜⬜⬜⬜⬜⬜⬜⬜
⬜⬜⬜⬛⬛⬛⬜⬜⬜⬛⬛⬛⬛⬜⬛⬜⬜⬜⬛⬜⬜⬛⬛⬛⬜⬛⬜⬜⬛⬛⬛⬜⬜⬛⬛⬜⬛⬛⬜⬛⬛⬛⬛⬜⬛⬛⬛⬛⬜⬛⬛⬜⬜⬜⬜
⬜⬛⬛⬜⬜⬜⬛⬜⬛⬜⬜⬛⬛⬜⬜⬛⬛⬛⬛⬛⬛⬛⬜⬜⬜⬛⬜⬛⬜⬛⬛⬛⬜⬛⬛⬜⬜⬜⬛⬜⬛⬜⬜⬜⬛⬜⬛⬜⬜⬜⬜⬛⬛⬛⬜
⬜⬜⬛⬜⬛⬜⬛⬛⬛⬜⬛⬛⬜⬛⬛⬛⬜⬜⬜⬜⬜⬛⬛⬛⬜⬛⬜⬛⬜⬜⬛⬜⬜⬛⬛⬛⬛⬛⬜⬛⬛⬛⬛⬛⬛⬜⬛⬛⬛⬜⬛⬛⬜⬜⬜
⬜⬜⬛⬛⬛⬜⬛⬛⬛⬛⬛⬛⬜⬛⬜⬛⬜⬛⬛⬜⬛⬛⬛⬛⬛⬛⬜⬛⬛⬛⬛⬛⬛⬜⬛⬜⬜⬛⬜⬛⬜⬜⬛⬜⬛⬛⬛⬜⬛⬜⬛⬜⬜⬛⬜
⬜⬜⬛⬜⬛⬛⬜⬛⬜⬜⬜⬜⬛⬛⬜⬛⬜⬛⬛⬛⬜⬛⬛⬛⬛⬛⬜⬛⬛⬜⬜⬜⬛⬜⬜⬛⬛⬜⬜⬛⬛⬛⬜⬛⬜⬜⬜⬜⬛⬛⬜⬛⬛⬜⬜
⬜⬜⬛⬜⬛⬛⬜⬜⬛⬛⬛⬛⬜⬜⬛⬛⬛⬜⬛⬛⬜⬛⬜⬜⬛⬜⬛⬛⬜⬛⬛⬛⬛⬛⬛⬜⬛⬛⬛⬜⬛⬜⬛⬛⬛⬛⬛⬛⬛⬛⬛⬛⬛⬛⬜
⬜⬜⬛⬛⬛⬜⬛⬛⬛⬜⬛⬜⬛⬛⬜⬜⬛⬜⬛⬜⬛⬛⬛⬛⬛⬜⬛⬛⬛⬛⬛⬛⬜⬜⬛⬜⬜⬛⬜⬛⬛⬛⬛⬜⬜⬛⬜⬜⬜⬛⬛⬛⬛⬛⬜
⬜⬛⬛⬜⬜⬛⬜⬜⬛⬜⬛⬜⬜⬛⬛⬛⬜⬜⬛⬛⬛⬛⬛⬜⬛⬛⬛⬛⬛⬜⬜⬛⬛⬛⬛⬜⬛⬜⬛⬜⬛⬜⬜⬛⬜⬛⬜⬛⬛⬛⬛⬛⬛⬛⬜
⬜⬛⬜⬛⬛⬛⬛⬜⬛⬜⬛⬛⬛⬜⬜⬜⬛⬛⬜⬛⬛⬜⬜⬛⬜⬜⬜⬛⬛⬛⬛⬜⬛⬜⬛⬜⬛⬜⬛⬜⬛⬜⬛⬛⬜⬛⬛⬛⬜⬛⬛⬜⬛⬛⬜
⬜⬛⬛⬛⬛⬜⬜⬛⬜⬛⬛⬜⬜⬛⬛⬛⬛⬜⬜⬜⬛⬜⬛⬛⬛⬛⬛⬛⬜⬛⬜⬜⬛⬜⬛⬜⬛⬛⬛⬛⬛⬜⬛⬛⬛⬜⬛⬜⬛⬜⬜⬛⬜⬜⬜
⬜⬛⬛⬛⬜⬛⬛⬛⬜⬛⬛⬛⬛⬜⬜⬜⬛⬛⬛⬜⬛⬜⬛⬜⬜⬜⬜⬜⬜⬛⬜⬛⬛⬜⬛⬛⬛⬜⬛⬜⬜⬜⬛⬛⬛⬛⬛⬜⬛⬜⬛⬛⬜⬛⬜
⬜⬛⬜⬜⬛⬛⬜⬛⬜⬛⬛⬛⬛⬛⬛⬛⬜⬜⬜⬛⬜⬛⬛⬛⬜⬛⬛⬛⬜⬛⬜⬛⬜⬛⬜⬛⬜⬜⬛⬛⬛⬛⬜⬛⬛⬜⬛⬜⬛⬛⬛⬜⬜⬛⬜
⬜⬛⬜⬛⬛⬛⬜⬛⬛⬛⬛⬛⬜⬜⬜⬛⬛⬛⬜⬜⬛⬛⬛⬛⬛⬜⬜⬛⬜⬛⬜⬛⬜⬜⬛⬛⬜⬛⬛⬛⬛⬜⬜⬜⬜⬛⬛⬜⬛⬛⬛⬛⬜⬛⬜
⬜⬛⬜⬜⬛⬛⬛⬛⬛⬜⬜⬜⬜⬛⬜⬜⬜⬛⬛⬜⬛⬛⬛*️⃣⬛⬜⬛⬛⬛⬛⬜⬛⬜⬛⬛⬛⬛⬛⬛⬛⬜⬜⬛⬛⬜⬛⬜⬛⬜⬛⬜⬛⬜⬛⬜
⬜⬛⬛⬜⬛⬛⬜⬛⬛⬛⬛⬛⬜⬛⬛⬛⬛⬜⬛⬛⬛⬛⬛⬛⬛⬛⬛⬜⬛⬛⬛⬜⬛⬛⬛⬛⬛⬛⬛⬛⬛⬜⬛⬜⬛⬜⬛⬛⬛⬛⬜⬜⬛⬛⬜
⬜⬛⬜⬛⬛⬜⬜⬛⬜⬜⬜⬛⬜⬛⬜⬜⬜⬜⬛⬜⬜⬜⬜⬛⬛⬛⬛⬜⬛⬛⬛⬜⬜⬜⬛⬛⬛⬛⬛⬛⬛⬛⬛⬛⬛⬜⬛⬛⬜⬜⬛⬛⬛⬜⬜
⬜⬜⬛⬛⬜⬛⬜⬛⬛⬛⬜⬛⬜⬜⬛⬛⬛⬜⬛⬜⬛⬜⬛⬛⬛⬛⬜⬛⬛⬛⬛⬛⬛⬛⬜⬛⬜⬛⬛⬛⬛⬛⬜⬜⬛⬜⬛⬛⬛⬛⬜⬜⬛⬜⬜
⬜⬜⬛⬜⬜⬛⬛⬜⬜⬛⬛⬛⬛⬛⬜⬛⬛⬛⬛⬜⬛⬜⬛⬜⬛⬛⬜⬛⬜⬛⬜⬜⬛⬜⬜⬛⬜⬛⬛⬛⬛⬛⬜⬛⬛⬜⬛⬛⬛⬛⬛⬛⬜⬛⬜
⬜⬛⬛⬛⬛⬜⬜⬛⬛⬛⬜⬛⬜⬛⬜⬛⬜⬛⬜⬜⬛⬜⬛⬜⬜⬛⬛⬛⬜⬛⬜⬛⬜⬛⬛⬛⬛⬜⬛⬜⬜⬛⬜⬛⬛⬜⬛⬛⬛⬛⬛⬛⬜⬛⬜
⬜⬛⬜⬛⬛⬛⬜⬛⬜⬛⬜⬛⬜⬛⬜⬛⬜⬛⬛⬛⬛⬛⬛⬜⬛⬛⬛⬛⬜⬛⬜⬛⬜⬛⬛⬛⬛⬛⬛⬛⬜⬛⬛⬜⬛⬛⬜⬜⬜⬛⬛⬛⬛⬛⬜
⬜⬜⬛⬜⬜⬛⬜⬜⬛⬜⬜⬛⬜⬛⬛⬛⬛⬜⬛⬜⬛⬜⬛⬛⬛⬛⬜⬛⬛⬛⬛⬜⬜⬛⬛⬜⬛⬛⬜⬜⬛⬛⬛⬛⬛⬛⬛⬛⬜⬛⬛⬛⬛⬛⬜
⬜⬛⬛⬛⬛⬛⬛⬛⬛⬛⬛⬛⬜⬛⬜⬛⬜⬛⬜⬛⬛⬜⬛⬜⬛⬜⬛⬜⬜⬜⬜⬛⬛⬛⬜⬛⬛⬛⬛⬛⬛⬛⬛⬛⬛⬛⬜⬜⬛⬛⬜⬜⬜⬛⬜
⬜⬜⬜⬛⬛⬜⬜⬜⬛⬜⬜⬜⬛⬛⬜⬜⬛⬛⬛⬜⬛⬛⬛⬜⬛⬜⬛⬛⬛⬛⬛⬜⬛⬛⬛⬜⬜⬜⬜⬛⬛⬛⬜⬛⬛⬛⬛⬛⬜⬜⬛⬛⬜⬛⬜
⬜⬛⬜⬛⬛⬜⬛⬛⬛⬛⬛⬛⬜⬛⬜⬛⬛⬛⬛⬛⬜⬜⬛⬜⬛⬜⬛⬛⬜⬜⬜⬛⬜⬛⬛⬜⬛⬛⬜⬛⬛⬛⬜⬜⬜⬛⬜⬛⬛⬜⬜⬜⬜⬛⬜
⬜⬜⬜⬛⬛⬛⬛⬜⬜⬜⬜⬜⬛⬛⬜⬛⬜⬜⬛⬛⬜⬛⬛⬜⬛⬛⬜⬛⬜⬛⬛⬛⬛⬜⬛⬜⬛⬛⬛⬜⬛⬜⬛⬛⬛⬜⬛⬜⬛⬛⬛⬜⬛⬛⬜
⬜⬛⬛⬜⬛⬜⬜⬛⬛⬛⬜⬛⬜⬛⬜⬛⬛⬛⬜⬛⬜⬛⬛⬛⬜⬜⬛⬜⬛⬜⬜⬜⬜⬛⬜⬛⬜⬜⬜⬛⬛⬛⬛⬜⬛⬛⬛⬜⬛⬛⬛⬜⬛⬜⬜
⬜⬜⬛⬜⬛⬜⬛⬛⬜⬛⬛⬛⬛⬜⬛⬛⬜⬛⬜⬛⬜⬛⬜⬛⬛⬛⬛⬛⬛⬛⬛⬛⬜⬛⬛⬛⬛⬛⬛⬜⬛⬛⬛⬜⬛⬜⬛⬜⬛⬛⬛⬜⬜⬛⬜
⬜⬛⬛⬜⬛⬛⬜⬛⬛⬜⬛⬛⬛⬜⬜⬜⬜⬛⬛⬛⬜⬛⬜⬜⬜⬛⬛⬛⬛⬛⬛⬜⬛⬜⬜⬛⬜⬜⬛⬜⬛⬛⬛⬛⬜⬛⬜⬛⬜⬜⬛⬛⬛⬜⬜
⬜⬛⬛⬛⬜⬜⬛⬛⬜⬛⬛⬜⬜⬛⬜⬛⬛⬜⬛⬜⬜⬛⬛⬛⬛⬛⬛⬛⬛⬛⬛⬛⬛⬛⬛⬜⬛⬛⬛⬛⬛⬛⬛⬛⬜⬛⬛⬛⬜⬛⬜⬛⬜⬛⬜
⬜⬛⬛⬛⬛⬛⬜⬛⬜⬛⬜⬛⬜⬛⬜⬛⬛⬛⬛⬛⬜⬛⬜⬜⬛⬜⬜⬜⬛⬛⬛⬛⬛⬛⬛⬛⬛⬜⬜⬛⬜⬛⬜⬜⬜⬜⬜⬜⬜⬛⬜⬛⬜⬜⬜
⬜⬛⬛⬜⬜⬜⬜⬛⬜⬛⬛⬛⬛⬛⬜⬛⬜⬛⬜⬜⬛⬜⬛⬜⬛⬛⬜⬛⬛⬛⬜⬛⬜⬛⬛⬛⬜⬛⬛⬜⬛⬛⬛⬛⬛⬛⬛⬛⬜⬛⬜⬛⬛⬛⬜
⬜⬜⬜⬛⬜⬛⬛⬛⬜⬛⬛⬛⬜⬜⬛⬜⬜⬛⬛⬜⬛⬛⬛⬜⬛⬛⬜⬛⬛⬛⬜⬛⬜⬛⬛⬜⬛⬛⬛⬛⬛⬜⬜⬛⬜⬛⬜⬛⬛⬜⬛⬜⬛⬜⬜
⬜⬛⬜⬛⬜⬛⬛⬛⬛⬛⬛⬛⬛⬜⬛⬛⬛⬜⬜⬛⬜⬛⬜⬛⬜⬛⬜⬛⬛⬛⬛⬛⬛⬛⬜⬛⬜⬜⬛⬜⬜⬛⬛⬛⬜⬛⬜⬜⬛⬛⬜⬛⬜⬛⬜
⬜⬜⬛⬜⬛⬛⬛⬛⬜⬜⬛⬛⬛⬜⬛⬛⬜⬛⬛⬜⬜⬜⬛⬛⬜⬛⬜⬛⬜⬜⬜⬜⬜⬛⬛⬜⬛⬛⬜⬛⬛⬛⬜⬜⬛⬛⬛⬛⬛⬜⬛⬛⬛⬛⬜
⬜⬛⬛⬜⬛⬜⬜⬛⬜⬛⬜⬜⬛⬜⬛⬛⬛⬜⬜⬛⬛⬛⬜⬛⬜⬛⬜⬜⬛⬛⬛⬛⬛⬜⬜⬛⬜⬛⬜⬛⬛⬛⬜⬛⬛⬛⬛⬜⬛⬛⬛⬜⬛⬛⬜
⬜⬜⬜⬛⬛⬛⬜⬛⬜⬛⬛⬜⬛⬜⬛⬜⬜⬛⬜⬛⬜⬜⬛⬛⬛⬜⬛⬜⬛⬜⬜⬛⬜⬛⬜⬛⬛⬛⬛⬜⬜⬜⬛⬛⬛⬛⬜⬛⬜⬜⬜⬜⬛⬛⬜
⬜⬛⬛⬛⬛⬛⬜⬛⬜⬜⬛⬛⬛⬛⬜⬛⬜⬛⬜⬛⬛⬛⬛⬜⬜⬜⬛⬜⬛⬜⬛⬛⬜⬛⬛⬛⬜⬛⬛⬛⬛⬛⬛⬛⬛⬛⬜⬛⬛⬛⬜⬛⬛⬜⬜
⬜⬜⬜⬜⬛⬜⬛⬛⬛⬛⬛⬛⬛⬛⬜⬛⬛⬛⬜⬛⬛⬜⬜⬜⬛⬛⬜⬜⬛⬜⬛⬛⬛⬛⬜⬛⬜⬜⬜⬜⬛⬛⬜⬛⬛⬛⬛⬛⬜⬛⬜⬛⬜⬛⬜
⬜⬛⬛⬜⬛⬛⬛⬜⬜⬛⬛⬛⬜⬛⬜⬛⬛⬜⬜⬛⬛⬛⬛⬛⬛⬛⬛⬛⬛⬛⬜⬜⬛⬛⬜⬛⬛⬛⬛⬛⬛⬜⬜⬛⬛⬛⬛⬛⬜⬛⬜⬛⬜⬛⬜
⬜⬜⬛⬜⬜⬜⬜⬛⬛⬜⬛⬜⬛⬛⬜⬛⬜⬜⬛⬜⬜⬜⬜⬜⬜⬜⬜⬜⬜⬜⬛⬜⬜⬛⬜⬜⬜⬜⬜⬜⬜⬛⬛⬜⬛⬛⬛⬛⬜⬛⬜⬛⬜⬜⬜
⬜⬛⬛⬛⬛⬛⬜⬛⬜⬜⬛⬜⬛⬜⬛⬜⬛⬛⬛⬛⬛⬛⬛⬛⬜⬛⬛⬛⬛⬛⬛⬜⬛⬜⬛⬛⬛⬛⬛⬛⬜⬜⬜⬛⬛⬛⬜⬜⬜⬛⬜⬛⬛⬛⬜
⬜⬜⬛⬜⬜⬛⬜⬛⬛⬛⬛⬜⬛⬛⬛⬜⬛⬜⬜⬜⬜⬛⬜⬛⬛⬜⬜⬜⬜⬜⬛⬜⬛⬛⬜⬜⬜⬜⬛⬜⬛⬛⬛⬜⬛⬜⬛⬛⬜⬛⬛⬛⬜⬜⬜
⬜⬛⬜⬛⬛⬜⬛⬛⬜⬜⬛⬜⬛⬛⬛⬜⬛⬛⬛⬛⬛⬛⬜⬛⬜⬛⬛⬛⬛⬛⬛⬜⬛⬜⬛⬛⬛⬜⬛⬛⬜⬜⬛⬜⬛⬜⬜⬛⬜⬛⬜⬛⬛⬛⬜
⬜⬜⬛⬛⬛⬜⬜⬛⬜⬛⬛⬜⬛⬛⬛⬛⬜⬜⬜⬜⬛⬛⬜⬛⬜⬜⬛⬛⬜⬛⬜⬛⬛⬛⬛⬛⬛⬛⬛⬛⬜⬛⬛⬜⬛⬜⬛⬛⬜⬛⬜⬜⬜⬜⬜
⬜⬜⬜⬜⬜⬛⬛⬛⬜⬜⬛⬛⬛⬜⬛⬜⬛⬛⬛⬛⬛⬛⬛⬛⬛⬜⬛⬜⬜⬛⬛⬜⬛⬛⬛⬛⬛⬛⬜⬛⬛⬛⬛⬜⬛⬜⬛⬜⬛⬜⬛⬛⬛⬛⬜
⬜⬛⬛⬛⬛⬛⬛⬜⬛⬛⬛⬜⬜⬜⬛⬜⬛⬛⬛⬛⬛⬜⬜⬜⬜⬜⬛⬛⬜⬛⬛⬛⬛⬛⬜⬜⬜⬛⬜⬜⬜⬜⬛⬜⬛⬛⬛⬜⬛⬜⬛⬛⬜⬜⬜
⬜⬜⬜⬛⬜⬛⬛⬛⬜⬛⬜⬛⬛⬛⬜⬛⬛⬛⬜⬛⬜⬛⬛⬛⬛⬛⬛⬛⬜⬛⬛⬛⬜⬛⬛⬛⬛⬛⬜⬛⬛⬜⬜⬛⬜⬜⬜⬜⬛⬛⬛⬜⬛⬜⬜
⬜⬛⬜⬜⬛⬜⬜⬜⬜⬛⬜⬜⬛⬛⬛⬜⬛⬜⬛⬛⬜⬛⬜⬛⬛⬜⬜⬛⬜⬛⬛⬛⬛⬜⬜⬛⬛⬛⬜⬛⬜⬛⬛⬛⬜⬛⬛⬛⬛⬛⬜⬜⬛⬜⬜
⬜⬛⬛⬛⬛⬛⬛⬛⬛⬛⬜⬛⬛⬜⬛⬜⬛⬛⬜⬜⬜⬜⬛⬛⬛⬛⬛⬜⬛⬛⬛⬜⬜⬛⬜⬛⬛⬛⬛⬛⬜⬜⬛⬜⬛⬛⬜⬛⬛⬛⬛⬛⬜⬛⬜
⬜⬜⬛⬛⬛⬛⬜⬜⬛⬛⬜⬛⬜⬜⬛⬜⬛⬜⬛⬛⬛⬛⬜⬛⬛⬛⬜⬛⬛⬛⬛⬜⭐⬛⬜⬛⬜⬜⬜⬜⬛⬛⬛⬜⬛⬛⬜⬛⬜⬜⬜⬜⬛⬛⬜
⬜⬛⬜⬛⬛⬛⬛⬜⬛⬛⬜⬛⬛⬛⬛⬛⬛⬛⬜⬛⬜⬛⬜⬜⬜⬛⬜⬛⬛⬛⬛⬛⬜⬜⬛⬛⬛⬛⬛⬛⬜⬜⬛⬜⬛⬜⬛⬛⬜⬛⬛⬜⬛⬛⬜
⬜⬛⬛⬛⬛⬛⬛⬜⬛⬛⬜⬜⬜⬛⬛⬜⬜⬛⬜⬛⬜⬛⬜⬛⬛⬛⬜⬛⬛⬛⬛⬛⬛⬛⬜⬜⬛⬜⬜⬛⬜⬛⬛⬛⬜⬛⬛⬛⬜⬜⬛⬜⬛⬜⬜
⬜⬛⬛⬜⬛⬛⬜⬜⬛⬜⬛⬛⬜⬛⬛⬜⬜⬛⬛⬜⬜⬛⬛⬛⬛⬛⬜⬜⬛⬜⬛⬜⬜⬛⬛⬛⬜⬛⬜⬛⬜⬛⬜⬜⬛⬜⬜⬜⬛⬛⬜⬛⬜⬜⬜
⬜⬜⬜⬜⬜⬜⬜⬜⬜⬜⬜⬜⬜⬜⬜⬜⬜⬜⬜⬜⬜⬜⬜⬜⬜⬜⬜⬜⬜⬜⬜⬜⬜⬜⬜⬜⬜⬜⬜⬜⬜⬜⬜⬜⬜⬜⬜⬜⬜⬜⬜⬜⬜⬜⬜
