⬜⬜⬜⬜⬜⬜⬜⬜⬜⬜⬜⬜⬜⬜⬜⬜⬜⬜⬜⬜⬜⬜⬜⬜⬜⬜⬜⬜⬜⬜⬜⬜⬜⬜⬜⬜⬜⬜⬜⬜⬜⬜⬜⬜⬜⬜⬜⬜⬜⬜⬜⬜⬜⬜⬜
⬜⬛⬛⬛⬜⬜⬜⬛⬛⬜⬛⬜⬜⬛⬛⬛⬛⬛⬛⬛⬛⬜⬛⬛⬜⬛⬛⬛⬛⬛⬛⬛⬛⬛⬜⬜⬛⬜⬛⬜⬜⬜⬜⬛⬜⬜⬛⬛⬛⬜⬛⬛⬜⬛⬜
⬜⬛⬛⬜⬛⬛⬛⬜⬛⬜⬛⬛⬜⬛⬜⬛⬜⬜⬛⬛⬛⬛⬜⬛⬜⬛⬛⬛⬛⬜⬛⬛⬛⬛⬜⬛⬜⬛⬜⬛⬛⬛⬛⬛⬛⬛⬜⬛⬛⬛⬛⬛⬛⬜⬜
⬜⬜⬛⬛⬜⬛⬛⬜⬛⬛⬜⬛⬛⬛⬜⬜⬛⬛⬛⬛⬛⬛⬜⬛⬜⬛⬛⬛⬛⬜⬛⬛⬛⬜⬛⬜⬛⬛⬛⬜⬛⬜⬛⬜⬜⬛⬜⬜⬜⬛⬜⬜⬛⬜⬜
⬜⬛⬜⬛⬛⬛⬜⬛⬛⬜⬛⬜⬛⬜⬛⬛⬛⬜⬜⬛⬛⬛⬜⬛⬛⬛⬛⬛⬛⬜⬛⬜⬛⬜⬛⬜⬛⬛⬛⬜⬛⬜⬛⬛⬛⬜⬛⬛⬛⬛⬜⬛⬜⬛⬜
⬜⬜⬛⬜⬜⬜⬛⬜⬜⬜⬛⬜⬛⬜⬛⬛⬜⬛⬛⬛⬜⬛⬜⬛⬜⬜⬛⬛⬛⬜⬛⬜⬛⬜⬛⬜⬜⬛⬛⬜⬛⬜⬜⬜⬜⬜⬛⬜⬛⬛⬜⬛⬜⬛⬜
⬜⬜⬜⬜⬛⬛⬜⬛⬛⬛⬜⬜⬛⬛⬛⬜⬛⬛⬛⬛⬜⬛⬜⬜⬜⬛⬜⬜⬜⬜⬛⬛⬜⬛⬜⬛⬜⬛⬜⬛⬛⬛⬛⬛⬛⬜⬛⬜⬜⬛⬜⬛⬜⬛⬜
⬜⬛⬛⬛⬛⬛⬜⬛⬛⬛⬛⬛⬛⬜⬛⬜⬜⬜⬜⬛⬛⬜⬛⬛⬛⬛⬛⬛⬛⬛⬜⬛⬜⬛⬛⬜⬜⬛⬜⬜⬜⬜⬛⬜⬜⬛⬛⬛⬛⬛⬜⬛⬜⬜⬜
⬜⬜⬜⬜⬛⬛⬜⬛⬜⬜⬜⬛⬜⬜⬜⬛⬛⬛⬜⬜⬜⬛⬛⬜⬜⬜⬜⬜⬜⬜⬜⬛⬜⬛⬛⬛⬛⬜⬛⬛⬛⬛⬛⬛⬜⬛⬛⬜⬛⬜⬛⬛⬛⬜⬜
⬜⬛⬛⬜⬛⬛⬜⬛⬛⬛⬛⬛⬛⬛⬜⬛⬜⬜⬛⬛⬜⬛⬛⬜⬛⬛⬛⬛⬛⬛⬜⬛⬛⬛⬛⬜⬛⬜⬛⬜⬜⬛⬜⬜⬛⬜⬛⬜⬛⬛⬛⬜⬛⬜⬜
⬜⬜⬜⬛⬛⬛⬛⬜⬜⬜⬜⬜⬛⬛⬛⬜⬜⬛⬛⬛⬛⬜⬛⬜⬛⬛⬛⬜⬜⬛⬜⬜⬜⬜⬛⬜⬛⬜⬛⬛⬛⬛⬛⬜⬛⬜⬛⬜⬛⬜⬜⬛⬜⬛⬜
⬜⬜⬛⬛⬛⬛⬛⬛⬛⬛⬛⬜⬜⬛⬛⬛⬛⬛⬛⬛⬜⬜⬛⬛⬛⬜⬛⬜⬛⬜⬛⬛⬛⬛⬛⬛⬜⬛⬜⬜⬜⬜⬜⬛⬛⬜⬛⬜⬛⬛⬛⬛⬜⬛⬜
⬜⬜⬛⬜⬛⬛⬜⬛⬛⬜⬜⬛⬛⬛⬜⬛⬛⬜⬜⬜⬛⬛⬜⬛⬛⬜⬛⬜⬛⬛⬜⬜⬜⬛⬛⬛⬜⬛⬜⬛⬛⬛⬛⬜⬛⬜⬛⬛⬜⬜⬜⬛⬜⬛⬜
⬜⬛⬜⬜⬛⬜⬛⬛⬛⬜⬛⬛⬛⬛⬜⬛⬛⬛⬛⬛⬜⬛⬜⬛⬛⬜⬛⬛⬛⬛⬛⬛⬛⬛⬛⬛⬜⬛⬛⬜⬜⬛⬜⬜⬛⬜⬛⬛⬛⬜⬛⬜⬜⬜⬜
⬜⬛⬛⬜⬛⬛⬜⬛⬛⬛⬛⬛⬜⬛⬜⬛⬛⬜⬛⬛⬛⬜⬜⬛⬛⬛⬜⬛⬛⬛⬛⬜⬛⬛⬛⬛⬜⬛⬜⬛⬛⬛⬛⬛⬛⬜⬛⬜⬜⬛⬛⬛⬛⬛⬜
⬜⬛⬛⬜⬛⬛⬛⬛⬜⬛⬛⬛⬜⬛⬛⬜⬛⬜⬛⬜⬛⬛⬛⬛⬛⬛⬛⬛⬜⬜⬜⬜⬜⬛⬛⬛⬜⬛⬜⬛⬜⬜⬜⬜⬛⬜⬛⬛⬛⬛⬜⬜⬛⬜⬜
⬜⬜⬜⬛⬜⬛⬜⬛⬜⬛⬛⬛⬜⬜⬛⬜⬛⬜⬛⬛⬜⬜⬛⬜⬛⬛⬛⬛⬛⬛⬛⬛⬛⬛⬛⬜⬛⬛⬜⬛⬜⬛⬛⬛⬛⬛⬛⬛⬛⬜⬛⬛⬛⬜⬜
⬜⬛⬛⬛⬜⬛⬜⬛⬜⬜⬜⬛⬛⬛⬜⬜⬛⬜⬛⬛⬜⬛⬜⬛⬛⬛⬛⬛⬜⬜⬜⬜⬜⬛⬜⬜⬛⬜⬜⬛⬛⬛⬜⬛⬛⬛⬛⬜⬛⬜⬛⬜⬛⬛⬜
⬜⬜⬜⬛⬛⬛⬜⬛⬛⬛⬛⬜⬜⬛⬜⬛⬛⬛⬛⬜⬜⬛⬜⬛⬛⬛⬜⬛⬛⬛⬛⬛⬛⬛⬛⬜⬛⬛⬛⬛⬜⬛⬜⬛⬛⬛⬛⬜⬛⬜⬛⬜⬛⬛⬜
⬜⬛⬛⬛⬛⬛⬜⬜⬛⬛⬛⬛⬛⬜⬛⬜⬜⬜⬜⬛⬛⬛⬜⬛⬜⬛⬜⬛⬜⬛⬜⬜⬜⬜⬛⬜⬛⬛⬜⬛⬜⬜⬛⬛⬜⬛⬜⬛⬛⬛⬜⬛⬛⬜⬜
⬜⬜⬜⬛⬛⬛⬛⬜⬜⬛⬜⬛⬜⬜⬛⬛⬛⬛⬛⬛⬜⬛⬛⬛⬜⬜⬛⬛⬜⬜⬛⬛⬛⬜⬛⬛⬜⬜⬛⬛⬛⬛⬜⬛⬜⬛⬛⬛⬜⬛⬛⬛⬛⬛⬜
⬜⬛⬜⬛⬜⬜⬛⬛⬛⬛⬜⬜⬜⬛⬛⬜⬛⬜⬜⬛⬜⬛⬜⬜⬜⬛⬛⬛⬛⬛⬜⬛⬜⬛⬛⬜⬛⬛⬜⬛⬜⬛⬜⬛⬛⬜⬜⬜⬛⬜⬜⬛⬛⬛⬜
⬜⬜⬜⬛⬛⬛⬜⬛⬜⬜⬛⬛⬛⬛⬛⬜⬛⬛⬛⬛⬜⬜⬛⬛⬛⬜⬜⬜⬛⬛⬜⬛⬜⬛⬜⬛⬜⬛⬜⬛⬜⬛⬛⬜⬜⬛⬛⬛⬜⬛⬛⬛⬛⬛⬜
⬜⬜⬛⬜⬜⬜⬛⬛⬛⬛⬜⬛⬜⬛⬜⬜⬛⬜⬜⬜⬛⬛⬛⬛⬛⬛⬛⬛⬛⬛⬛⬜⬜⬛⬛⬛⬜⬛⬜⬜⬛⬜⬛⬛⬛⬛⬛⬜⬜⬛⬜⬜⬜⬜⬜
⬜⬛⬛⬜⬛⬜⬛⬜⬜⬜⬜⬛⬜⬛⬛⬜⬛⬜⬛⬛⬜⬜⬜⬜⬜⬜⬜⬛⬛⬜⬜⬛⬛⬛⬜⬛⬛⬜⬛⬛⬛⬜⬛⬛⬛⬛⬛⬛⬛⬛⬛⬛⬛⬛⬜
⬜⬛⬛⬛⬛⬜⬛⬜⬛⬛⬛⬛⬜⬛⬛⬛⬛⬜⬜⬜⬛⬛⬛⬛⬛⬛⬛⬛⬛⬛⬛⬛⬜⬛⬜⬛⬜⬛⬛⬛⬛⬜⬛⬛⬛⬛⬛⬜⬜⬜⬛⬜⬜⬛⬜
⬜⬜⬜⬛⬜⬛⬛⬜⬛⬜⬛⬛⬜⬛⬛⬜⬜⬛⬛⬛⬛⬜⬜⬛⬜⬜⬜⬛⬛⬜⬜⬜⬛⬜⬛⬛⬜⬛⬛⬜⬜⬛⬛⬛⬜⬛⬜⬛⬛⬛⬜⬛⬛⬜⬜
⬜⬜⬛⬜⬛⬜⬜⬜⬛⬜⬛⬜⬜⬛⬜⬛⬛⬛⬜⬜⬜⬛⬜⬛⬛⬛⬜⬛⬛⬜⬛⬛⬜⬛⬜⬛⬜⬛⬜⬛⬛⬛⬛⬛⬛⬜⬛⬛⬛⬛⬜⬜⬛⬛⬜
⬜⬜⬛⬛⬜⬛⬛⬛⬜⬛⬛⬛⬛⬛⬜⬜⬜⬛⬜⬛⬛⬜⬛⬛⬜⬛⬛⬛⬛⬜⬜⬜⬛⬛⬛⬛⬛⬛⬜⬛⬛⬛⬛⬛⬜⬛⬜⬜⬛⬛⬛⬛⬜⬛⬜
⬜⬛⬜⬛⬜⬛⬜⬜⬜⬛⬛⬛⬜⬜⬛⬛⬛⬛⬛⬛⬜⬛⬜⬛⬜⬛⬜⬜⬜⬛⬛⬛⬜⬛⬜⬛⬜⬜⬜⬛⬜⬛⬜⬛⬛⬜⬛⬜⬛⬛⬛⬛⬜⬛⬜
⬜⬛⬛⬜⬛⬜⬛⬛⬜⬛⬜⬛⬛⬜⬛⬜⬜⬛⬜⬛⬜⬜⬛⬛⬜⬛⬛⬜⬛⬛⬛⬜⬛⬛⬜⬜⬛⬛⬜⬛⬜⬛⬜⬛⬛⬛⬛⬜⬛⬛⬛⬛⬜⬛⬜
⬜⬜⬛⬛⬛⬛⬛⬛⬛⬛⬜⬛⬜⬛⬜⬛⬛⬛⬜⬛⬜⬛⬛⬛⬜⬜⬛⬛⬜⬜⬜⬛⬜⬛⬛⬛⬜⬜⬜⬛⬜⬛⬛⬜⬛⬛⬛⬜⬜⬛⬛⬛⬛⬜⬜
⬜⬛⬛⬛⬛⬛⬛⬛⬜⬛⬛⬛⬛⬛⬛⬜⬛⬜⬜⬛⬜⬛⬛⬜⬛⬜⬛⬛⬜⬛⬛⬜⬛⬛⬜⬜⬛⬛⬛⬜⬛⬜⬛⬜⬛⬜⬛⬜⬛⬛⬛⬜⬜⬛⬜
⬜⬛⬛⬛⬜⬛⬜⬛⬜⬛⬛⬛⬛⬛⬜⬜⬛⬛⬛⬛⬜⬛⬜⬛⬛⬛⬜⬛⬛⬜⬛⬜⬛⬜⬛⬜⬛⬜⬛⬛⬛⬛⬛⬜⬛⬜⬛⬜⬜⬛⬛⬛⬛⬛⬜
⬜⬜⬜⬛⬜⬛⬜⬛⬜⬛⬛⬜⬛⬛⬛⬜⬜⬛⬛⬛⬜⬜⬛⬛⬜⬛⬛⬜⬛⬜⬜⬜⬛⬛⬛⬜⬛⬛⬜⬜⬜⬜⬛⬜⬛⬛⬛⬛⬜⬛⬛⬜⬛⬜⬜
⬜⬛⬜⬛⬜⬛⬜⬛⬜⬜⬛⬛⬜⬜⬛⬛⬛⬛⬜⬜⬛⬛⬜⬜⬛⬜⬛⬜⬜⬛⬛⬛⬛⬜⬛⬜⬛⬛⬛⬛⬛⬛⬛⬜⬛⬛⬜⬛⬜⬛⬛⬛⬜⬛⬜
⬜⬛⬜⬛⬜⬜⬛⬛⬛⬜⬜⬛⬜⬛⬛⬜⬜⬜⬜⬜⬛⬛⬜⬜⬛⬜⬛⬜⬛⬛⬛⬛⬛⬜⬛⬜⬛⬜⬜⬜⬛⬜⬛⬛⬜⬛⬜⬛⬛⬛⬜⬛⬜⭐⬜
⬜⬜⬛⬛⬛⬛⬛⬛⬛⬜⬛⬛⬜⬛⬜⬛⬛⬛⬛⬛⬛⬛⬛⬛⬜⬜⬛⬛⬛⬛⬛⬜⬛⬜⬛⬛⬛⬛⬛⬛⬜⬛⬛⬜⬛⬛⬛⬜⬛⬜⬛⬜⬛⬛⬜
⬜⬛⬛⬜⬜⬜⬛⬛⬛⬜⬛⬜⬛⬛⬜⬛⬜⬜⬜⬛⬛⬛⬜⬛⬜⬛⬜⬜⬜⬛⬛⬜⬛⬛⬜⬜⬜⬛⬜⬛⬛⬛⬜⬜⬛⬛⬛⬛⬛⬛⬛⬛⬛⬜⬜
⬜⬜⬜⬛⬛⬛⬛⬛⬜⬛⬜⬜⬛⬛⬛⬛⬛⬛⬜⬛⬜⬛⬜⬛⬜⬜⬜⬛⬛⬛⬜⬛⬛⬛⬛⬛⬜⬛⬜⬜⬜⬜⬛⬛⬛⬜⬛⬜⬛⬛⬛⬜⬜⬜⬜
⬜⬜⬛⬛⬛⬜⬜⬛⬜⬛⬛⬜⬛⬜⬛⬜⬜⬜⬛⬜⬜⬛⬜⬛⬛⬛⬛⬛⬛⬜⬜⬜⬜⬜⬜⬛⬜⬛⬛⬛⬛⬛⬜⬜⬛⬜⬛⬜⬛⬛⬛⬜⬛⬛⬜
⬜⬛⬜⬛⬜⬛⬜⬛⬜⬛⬛⬛⬛⬜⬜⬛⬛⬛⬛⬛⬛⬛⬛⬜⬜⬜⬛⬛⬛⬛⬛⬛⬛⬛⬛⬛⬛⬜⬜⬜⬜⬛⬜⬛⬜⬜⬛⬛⬛⬜⬛⬜⬜⬛⬜
⬜⬜⬜⬛⬜⬛⬛⬛⬜⬜⬜⬛⬜⬜⬛⬛⬛⬜⬜⬛⬜⬜⬜⬛⬛⬛⬜⬜⬜⬜⬜⬛⬛⬛⬜⬛⬜⬛⬛⬛⬛⬛⬜⬛⬜⬛⬛⬜⬛⬜⬛⬛⬜⬛⬜
⬜⬜⬛⬛⬜⬛⬜⬛⬛⬛⬛⬛⬛⬛⬜⬛⬜⬛⬛⬛⬜⬛⬛⬜⬜⬛⬜⬛⬛⬛⬛⬜⬜⬜⬛⬛⬜⬜⬛⬛⬜⬛⬛⬛⬜⬜⬛⬜⬛⬛⬜⬛⬛⬜⬜
⬜⬜⬛⬜⬜⬛⬜⬛⬛⬜⬛⬜⬜⬛⬛⬛⬛⬛⬛⬜⬛⬛⬛⬛⬜⬛⬛⬜⬛⬛⬛⬜⬛⬛⬜⬜⬛⬛⬜⬛⬛⬜⬜⬜⬛⬜⬛⬜⬛⬛⬛⬜⬜⬛⬜
⬜⬛⬜⬛⬛⬜⬛⬛⬛⬛⬜⬛⬛⬛⬜⬜⬜⬜⬛⬜⬛*️⃣⬛⬛⬜⬜⬛⬜⬛⬛⬛⬜⬜⬛⬜⬛⬛⬜⬜⬛⬜⬛⬛⬛⬛⬛⬛⬜⬛⬜⬛⬛⬛⬛⬜
⬜⬛⬛⬜⬜⬛⬜⬛⬛⬜⬛⬜⬜⬛⬛⬛⬛⬛⬜⬛⬛⬛⬛⬜⬜⬛⬛⬛⬛⬛⬛⬛⬛⬛⬛⬛⬜⬛⬛⬜⬜⬛⬜⬛⬛⬜⬜⬜⬛⬜⬜⬛⬜⬛⬜
⬜⬜⬛⬜⬛⬛⬜⬛⬛⬛⬜⬛⬛⬜⬛⬜⬛⬛⬜⬜⬜⬛⬛⬛⬛⬛⬜⬛⬛⬜⬜⬛⬛⬛⬜⬜⬜⬜⬛⬜⬛⬛⬜⬛⬜⬛⬛⬜⬛⬜⬛⬜⬛⬛⬜
⬜⬛⬛⬜⬛⬜⬛⬜⬛⬛⬜⬜⬜⬜⬛⬜⬛⬛⬜⬛⬛⬜⬜⬜⬛⬜⬜⬜⬛⬜⬛⬛⬛⬛⬛⬛⬛⬛⬜⬛⬜⬛⬜⬛⬛⬜⬛⬜⬜⬜⬛⬛⬜⬛⬜
⬜⬜⬛⬜⬛⬜⬛⬜⬜⬜⬛⬛⬛⬛⬛⬛⬜⬛⬛⬛⬛⬛⬜⬛⬜⬛⬛⬜⬛⬛⬛⬜⬜⬛⬜⬛⬜⬜⬜⬛⬜⬛⬜⬜⬜⬛⬛⬛⬛⬛⬛⬛⬛⬛⬜
⬜⬛⬜⬜⬛⬛⬜⬛⬛⬛⬜⬜⬜⬜⬜⬜⬛⬜⬛⬛⬛⬛⬛⬛⬛⬛⬜⬛⬜⬜⬛⬛⬛⬛⬜⬜⬜⬛⬛⬛⬜⬛⬛⬛⬛⬛⬜⬜⬜⬜⬜⬛⬜⬜⬜
⬜⬛⬜⬛⬛⬛⬛⬜⬛⬛⬛⬛⬛⬛⬛⬛⬜⬜⬛⬛⬛⬛⬜⬛⬛⬛⬜⬛⬛⬜⬛⬛⬛⬜⬛⬛⬛⬜⬜⬜⬛⬜⬛⬜⬜⬛⬜⬛⬛⬛⬜⬛⬜⬛⬜
⬜⬛⬜⬜⬜⬛⬛⬛⬛⬛⬛⬜⬜⬜⬛⬛⬛⬛⬛⬜⬜⬛⬜⬛⬜⬜⬛⬜⬛⬜⬜⬜⬜⬛⬜⬜⬜⬜⬛⬛⬜⬛⬜⬛⬛⬛⬜⬛⬜⬛⬜⬛⬜⬜⬜
⬜⬛⬛⬜⬛⬛⬛⬛⬛⬛⬛⬛⬜⬛⬛⬜⬜⬛⬜⬛⬜⬛⬛⬛⬜⬛⬛⬜⬛⬜⬛⬛⬜⬛⬛⬛⬛⬛⬛⬜⬜⬛⬜⬛⬜⬜⬛⬜⬜⬜⬜⬜⬛⬜⬜
⬜⬜⬜⬜⬜⬜⬜⬜⬜⬜⬜⬜⬜⬜⬜⬜⬜⬜⬜⬜⬜⬜⬜⬜⬜⬜⬜⬜⬜⬜⬜⬜⬜⬜⬜⬜⬜⬜⬜⬜⬜⬜⬜⬜⬜⬜⬜⬜⬜⬜⬜⬜⬜⬜⬜
