⬜⬜⬜⬜⬜⬜⬜⬜⬜⬜⬜⬜⬜⬜⬜⬜⬜⬜⬜⬜⬜⬜⬜⬜⬜⬜⬜⬜⬜⬜⬜⬜⬜⬜⬜⬜⬜⬜⬜⬜⬜⬜⬜⬜⬜⬜⬜⬜⬜⬜⬜⬜⬜⬜⬜
⬜⬛⬜⬛⬛⬜⬛⬜⬜⬜⬜⬜⬜⬛⬛⬜⬛⬛⬜⬛⬛⬜⬜⬛⬜⬜⬛⬛⬛⬛⬛⬜⬛⬜⬛⬛⬜⬜⬛⬜⬜⬛⬜⬛⬜⬜⬛⬜⬛⬛⬛⬜⬜⬜⬜
⬜⬛⬜⬜⬛⬜⬜⬛⬛⬛⬛⬜⬛⬜⬛⬛⬜⬜⬛⬜⬜⬛⬛⬜⬜⬛⬛⬛⬛⬜⬜⬜⬛⬛⬛⬛⬛⬜⬜⬜⬛⬜⬛⬛⬛⬜⬛⬜⬛⬛⬛⬜⬜⬛⬜
⬜⬛⬛⬜⬜⬛⬛⬜⬜⬜⬜⬛⬛⬜⬜⬜⬛⬛⬛⬛⬜⬛⬜⬛⬛⬛⬛⬛⬛⬜⬛⬛⬛⬛⬛⬛⬜⬛⬛⬛⬛⬛⬛⬜⬛⬛⬛⬜⬛⬛⬜⬛⬛⬛⬜
⬜⬛⬛⬛⬛⬜⬛⬜⬛⬛⬜⬛⬜⬛⬛⬛⬛⬜⬜⬛⬛⬛⬜⬛⬜⬛⬜⬜⬛⬜⬛⬜⬜⬛⬛⬜⬛⬜⬜⬛⬛⬛⬛⬜⬛⬛⬜⬛⬛⬜⬛⬜⬛⬜⬜
⬜⬛⬛⬜⬜⬛⬛⬜⬛⬛⬜⬛⬜⬛⬜⬜⬜⬛⬜⬜⬜⬜⬜⬛⬜⬛⬛⬛⬜⬜⬛⬜⬛⬜⬛⬛⬛⬛⬛⬜⬜⬜⬛⬛⬛⬜⬛⬛⬜⬜⬛⬜⬛⬜⬜
⬜⭐⬛⬛⬛⬛⬜⬛⬛⬛⬜⬛⬜⬛⬛⬛⬛⬛⬛⬛⬛⬛⬛⬛⬜⬜⬜⬛⬛⬛⬛⬜⬛⬜⬛⬜⬜⬛⬛⬛⬛⬛⬜⬜⬜⬛⬜⬛⬛⬛⬛⬜⬛⬜⬜
⬜⬜⬜⬛⬜⬜⬛⬜⬜⬛⬛⬛⬜⬛⬜⬜⬛⬜⬜⬛⬜⬛⬜⬛⬜⬛⬛⬜⬜⬛⬜⬜⬛⬛⬛⬛⬜⬛⬜⬜⬛⬜⬜⬛⬜⬛⬜⬜⬛⬜⬛⬜⬜⬛⬜
⬜⬛⬛⬜⬛⬛⬛⬛⬛⬛⬜⬛⬛⬜⬛⬛⬜⬛⬛⬛⬜⬛⬛⬜⬛⬜⬜⬛⬛⬜⬛⬛⬛⬛⬛⬜⬛⬛⬜⬛⬜⬛⬛⬜⬛⬛⬛⬛⬛⬜⬛⬛⬛⬛⬜
⬜⬜⬜⬛⬛⬛⬛⬛⬛⬜⬜⬛⬛⬛⬛⬛⬜⬛⬜⬛⬛⬜⬛⬛⬜⬛⬛⬛⬛⬜⬛⬜⬜⬜⬛⬜⬛⬛⬛⬛⬜⬛⬛⬜⬛⬜⬜⬜⬛⬜⬜⬛⬜⬛⬜
⬜⬛⬛⬛⬜⬛⬛⬛⬛⬛⬛⬛⬜⬛⬜⬜⬜⬛⬛⬜⬜⬛⬛⬜⬛⬜⬛⬛⬛⬜⬜⬛⬛⬜⬛⬛⬜⬜⬜⬛⬛⬜⬛⬜⬜⬛⬛⬜⬛⬛⬜⬜⬛⬜⬜
⬜⬜⬛⬜⬛⬛⬛⬜⬜⬜⬜⬜⬜⬛⬛⬜⬛⬜⬛⬛⬛⬛⬜⬛⬛⬜⬜⬛⬜⬛⬛⬜⬛⬛⬜⬛⬛⬛⬛⬜⬛⬜⬛⬛⬛⬛⬛⬛⬜⬜⬛⬛⬛⬜⬜
⬜⬜⬜⬛⬛⬛⬛⬛⬛⬛⬛⬜⬛⬛⬜⬛⬛⬛⬛⬛⬛⬛⬛⬜⬛⬜⬛⬛⬜⬛⬛⬜⬛⬛⬜⬜⬜⬛⬜⬛⬛⬜⬛⬛⬛⬜⬜⬛⬛⬛⬜⬜⬛⬜⬜
⬜⬛⬛⬜⬛⬜⬛⬜⬜⬛⬛⬜⬛⬜⬛⬛⬛⬜⬛⬛⬛⬛⬛⬛⬜⬜⬛⬜⬛⬛⬜⬛⬛⬜⬛⬛⬜⬛⬜⬛⬜⬜⬛⬜⬛⬜⬛⬜⬜⬛⬛⬛⬛⬜⬜
⬜⬛⬛⬜⬛⬜⬛⬛⬛⬜⬛⬜⬛⬜⬛⬜⬛⬜⬜⬜⬛⬛⬛⬛⬛⬛⬜⬛⬛⬜⬛⬛⬜⬜⬛⬛⬜⬛⬜⬛⬜⬛⬛⬜⬛⬛⬛⬛⬛⬛⬜⬜⬜⬜⬜
⬜⬜⬛⬜⬛⬜⬛⬜⬛⬛⬛⬛⬛⬜⬛⬜⬛⬛⬛⬜⬛⬛⬜⬜⬜⬜⬛⬛⬛⬛⬛⬛⬛⬛⬛⬛⬜⬜⬛⬛⬜⬛⬛⬜⬛⬜⬜⬛⬛⬛⬛⬛⬛⬛⬜
⬜⬜⬛⬜⬛⬜⬛⬜⬛⬛⬛⬜⬜⬛⬛⬛⬜⬜⬛⬜⬛⬛⬜⬛⬛⬛⬛⬜⬜⬜⬜⬜⬛⬛⬛⬛⬛⬛⬛⬜⬛⬛⬛⬛⬛⬛⬛⬛⬛⬛⬛⬛⬛⬛⬜
⬜⬛⬛⬛⬛⬛⬛⬛⬜⬜⬜⬛⬛⬜⬛⬜⬛⬛⬛⬛⬛⬜⬛⬛⬜⬛⬛⬛⬛⬛⬛⬛⬜⬜⬛⬜⬜⬜⬛⬜⬜⬜⬛⬛⬛⬜⬛⬛⬛⬜⬜⬜⬛⬜⬜
⬜⬜⬜⬜⬛⬛⬛⬛⬛⬛⬛⬜⬛⬜⬛⬜⬛⬜⬛⬛⬛⬜⬜⬛⬜⬜⬛⬛⬛⬛⬛⬛⬜⬛⬜⬛⬛⬛⬛⬛⬛⬛⬛⬛⬛⬜⬛⬛⬜⬛⬜⬛⬜⬛⬜
⬜⬛⬛⬛⬜⬜⬜⬛⬛⬜⬛⬛⬛⬜⬜⬜⬛⬜⬛⬜⬛⬛⬛⬛⬛⬜⬛⬛⬜⬛⬜⬛⬜⬛⬜⬛⬜⬛⬜⬜⬛⬛⬛⬛⬛⬜⬛⬛⬜⬜⬛⬛⬛⬛⬜
⬜⬛⬜⬛⬜⬛⬛⬛⬛⬜⬜⬛⬛⬛⬛⬛⬛⬛⬛⬜⬜⬜⬜⬜⬛⬜⬜⬛⬜⬛⬜⬛⬜⬛⬜⬛⬜⬛⬛⬛⬛⬛⬛⬛⬛⬜⬜⬜⬛⬛⬛⬛⬛⬜⬜
⬜⬛⬜⬛⬜⬜⬜⬜⬛⬜⬛⬜⬛⬛⬛⬜⬜⬛⬜⬛⬛⬜⬛⬜⬜⬛⬛⬜⬛⬛⬜⬛⬜⬛⬜⬛⬛⬜⬜⬜⬜⬜⬜⬜⬜⬜⬛⬛⬛⬛⬛⬜⬛⬜⬜
⬜⬜⬛⬜⬛⬛⬛⬛⬜⬜⬛⬛⬜⬛⬜⬛⬛⬛⬜⬜⬛⬛⬛⬛⬜⬛⬜⬜⬛⬛⬜⬛⬜⬛⬜⬛⬜⬛⬛⬛⬛⬛⬛⬛⬛⬛⬛⬛⬛⬛⬛⬜⬜⬛⬜
⬜⬛⬛⬜⬛⬜⬜⬛⬛⬜⬜⬛⬜⬛⬜⬜⬜⬛⬛⬛⬛⬛⬜⬛⬜⬛⬛⬜⬛⬛⬜⬛⬜⬛⬜⬛⬜⬛⬛⬛⬛⬜⬜⬜⬜⬛⬛⬛⬜⬜⬛⬛⬜⬛⬜
⬜⬜⬜⬛⬛⬜⬛⬛⬛⬜⬛⬛⬜⬛⬛⬛⬛⬛⬛⬜⬛⬜⬛⬛⬜⬛⬛⬛⬛⬜⬛⬛⬜⬜⬛⬛⬜⬜⬛⬛⬛⬜⬛⬛⬛⬛⬛⬛⬜⬛⬜⬛⬜⬛⬜
⬜⬛⬜⬛⬜⬛⬜⬛⬛⬛⬛⬛⬛⬛⬜⬛⬛⬛⬛⬜⬛⬜⬛⬜⬜⬛⬛⬜⬛⬜⬛⬜⬛⬛⬛⬛⬛⬛⬛⬛⬛⬜⬜⬜⬛⬛*️⃣⬛⬛⬛⬜⬛⬜⬜⬜
⬜⬜⬛⬛⬜⬛⬜⬛⬛⬛⬛⬜⬛⬜⬛⬜⬛⬜⬛⬜⬛⬛⬜⬛⬛⬛⬜⬛⬜⬛⬜⬛⬛⬜⬛⬜⬜⬜⬜⬛⬛⬛⬛⬛⬛⬛⬛⬛⬛⬛⬛⬛⬛⬛⬜
⬜⬛⬜⬛⬜⬛⬛⬜⬛⬛⬜⬜⬛⬛⬛⬜⬛⬜⬛⬜⬜⬜⬛⬜⬜⬛⬜⬛⬜⬛⬛⬛⬜⬜⬛⬛⬛⬛⬛⬛⬛⬛⬜⬜⬛⬜⬜⬜⬛⬛⬛⬛⬜⬜⬜
⬜⬛⬛⬛⬛⬜⬛⬛⬛⬛⬛⬜⬜⬛⬛⬜⬛⬜⬛⬜⬛⬛⬛⬜⬛⬛⬜⬛⬜⬛⬜⬛⬛⬛⬜⬛⬜⬛⬜⬜⬛⬜⬛⬜⬛⬛⬛⬛⬛⬛⬛⬛⬛⬛⬜
⬜⬜⬜⬜⬜⬜⬛⬛⬛⬛⬛⬜⬛⬜⬛⬛⬛⬜⬛⬜⬛⬜⬛⬛⬛⬜⬛⬜⬛⬛⬜⬛⬛⬛⬛⬜⬛⬜⬛⬜⬛⬜⬛⬜⬜⬛⬜⬜⬜⬜⬛⬛⬜⬜⬜
⬜⬛⬛⬛⬛⬛⬛⬛⬛⬛⬜⬜⬛⬜⬛⬜⬜⬛⬛⬜⬛⬜⬛⬜⬜⬛⬜⬛⬛⬛⬜⬛⬜⬜⬜⬜⬛⬛⬛⬛⬛⬜⬛⬜⬛⬜⬛⬛⬛⬜⬛⬛⬛⬜⬜
⬜⬛⬛⬛⬛⬜⬛⬜⬛⬛⬛⬜⬛⬛⬜⬛⬛⬛⬛⬜⬜⬜⬛⬛⬜⬜⬛⬜⬜⬛⬜⬛⬛⬛⬛⬛⬛⬛⬜⬜⬛⬜⬛⬛⬛⬜⬛⬜⬛⬛⬜⬜⬛⬜⬜
⬜⬜⬜⬛⬜⬛⬛⬜⬜⬜⬛⬜⬛⬜⬜⬛⬜⬛⬜⬛⬛⬛⬛⬛⬛⬛⬛⬛⬛⬛⬜⬜⬜⬜⬛⬛⬛⬛⬜⬜⬛⬜⬛⬜⬜⬛⬜⬛⬜⬛⬛⬛⬛⬛⬜
⬜⬛⬛⬛⬛⬜⬜⬛⬛⬜⬛⬛⬛⬜⬜⬛⬛⬜⬛⬛⬜⬛⬜⬜⬜⬜⬜⬜⬜⬛⬜⬛⬛⬛⬜⬜⬜⬛⬜⬛⬛⬜⬜⬛⬜⬛⬜⬛⬜⬜⬜⬜⬜⬜⬜
⬜⬛⬜⬜⬛⬛⬜⬛⬜⬛⬜⬜⬛⬛⬛⬛⬜⬛⬛⬜⬛⬛⬛⬛⬛⬛⬛⬛⬛⬛⬜⬛⬜⬜⬛⬛⬛⬛⬛⬜⬛⬛⬛⬛⬜⬛⬜⬛⬛⬛⬛⬛⬛⬛⬜
⬜⬛⬛⬜⬛⬛⬛⬛⬜⬛⬛⬛⬜⬛⬜⬛⬜⬜⬛⬛⬛⬜⬜⬜⬛⬛⬜⬛⬜⬜⬛⬜⬛⬜⬛⬜⬛⬛⬜⬜⬜⬜⬜⬜⬛⬜⬛⬛⬛⬛⬛⬛⬛⬛⬜
⬜⬜⬛⬜⬛⬜⬛⬛⬜⬛⬜⬛⬛⬛⬜⬛⬛⬜⬛⬜⬛⬛⬛⬛⬛⬛⬜⬛⬛⬜⬛⬜⬛⬛⬛⬜⬛⬜⬛⬛⬛⬛⬛⬛⬛⬛⬛⬛⬛⬜⬜⬛⬛⬛⬜
⬜⬜⬛⬛⬜⬛⬛⬜⬜⬛⬜⬛⬛⬛⬛⬜⬛⬜⬛⬜⬜⬛⬛⬜⬜⬛⬜⬛⬜⬛⬛⬜⬛⬛⬜⬜⬛⬜⬛⬜⬜⬜⬜⬜⬜⬛⬛⬜⬜⬛⬜⬛⬛⬛⬜
⬜⬛⬜⬜⬛⬛⬛⬛⬜⬛⬛⬛⬛⬜⬜⬛⬜⬛⬛⬛⬜⬛⬛⬜⬜⬛⬜⬛⬜⬛⬛⬜⬛⬛⬛⬛⬛⬛⬜⬛⬛⬛⬛⬛⬛⬛⬛⬛⬜⬜⬛⬛⬛⬛⬜
⬜⬛⬛⬛⬜⬜⬜⬛⬜⬛⬜⬜⬛⬜⬛⬛⬛⬜⬛⬜⬛⬛⬛⬛⬜⬛⬛⬛⬛⬜⬛⬜⬛⬜⬜⬛⬜⬛⬛⬛⬜⬜⬜⬛⬛⬛⬜⬛⬛⬛⬛⬛⬜⬜⬜
⬜⬛⬜⬜⬛⬛⬛⬛⬜⬛⬜⬛⬛⬜⬜⬛⬜⬛⬛⬜⬛⬛⬛⬛⬜⬜⬜⬜⬛⬛⬜⬛⬛⬜⬛⬛⬜⬛⬜⬛⬛⬛⬛⬛⬛⬛⬛⬜⬛⬛⬜⬛⬛⬜⬜
⬜⬜⬛⬛⬛⬜⬛⬛⬛⬛⬛⬛⬜⬛⬛⬜⬜⬜⬜⬛⬛⬛⬜⬜⬛⬛⬛⬛⬜⬛⬛⬛⬛⬛⬜⬜⬛⬛⬜⬛⬜⬜⬛⬛⬛⬛⬜⬜⬜⬜⬛⬜⬛⬛⬜
⬜⬜⬜⬛⬜⬛⬜⬜⬛⬜⬛⬜⬛⬜⬜⬛⬛⬛⬜⬛⬛⬛⬜⬛⬛⬜⬜⬛⬜⬛⬜⬜⬜⬜⬛⬛⬜⬛⬛⬛⬛⬛⬜⬛⬛⬛⬜⬛⬛⬜⬛⬜⬛⬜⬜
⬜⬜⬛⬛⬜⬛⬛⬛⬛⬜⬛⬛⬜⬜⬛⬜⬛⬛⬜⬛⬛⬛⬛⬜⬜⬛⬜⬜⬛⬛⬛⬜⬛⬛⬜⬛⬜⬜⬜⬛⬜⬛⬜⬜⬛⬛⬛⬜⬛⬛⬛⬜⬛⬜⬜
⬜⬜⬜⬛⬜⬜⬜⬛⬛⬜⬛⬜⬛⬛⬜⬛⬜⬛⬛⬜⬛⬛⬛⬛⬛⬛⬛⬛⬛⬛⬛⬛⬛⬜⬛⬜⬛⬛⬜⬛⬜⬜⬛⬛⬜⬛⬛⬜⬛⬜⬜⬛⬜⬛⬜
⬜⬜⬛⬜⬛⬛⬛⬛⬛⬜⬛⬛⬛⬛⬜⬛⬜⬛⬜⬛⬛⬜⬜⬜⬜⬜⬛⬜⬜⬜⬛⬜⬜⬜⬛⬛⬜⬛⬛⬜⬛⬛⬜⬛⬜⬛⬛⬛⬜⬜⬛⬜⬜⬛⬜
⬜⬛⬛⬛⬜⬛⬜⬜⬛⬛⬛⬜⬛⬛⬛⬛⬛⬜⬜⬛⬜⬛⬛⬛⬛⬛⬜⬜⬛⬛⬜⬛⬛⬛⬜⬛⬜⬛⬜⬛⬛⬛⬜⬛⬜⬛⬜⬜⬛⬛⬛⬛⬛⬛⬜
⬜⬜⬜⬜⬛⬜⬛⬛⬜⬛⬜⬜⬜⬛⬛⬛⬛⬜⬛⬛⬜⬛⬜⬜⬜⬜⬛⬛⬜⬛⬛⬜⬛⬜⬛⬜⬛⬜⬜⬛⬛⬛⬛⬛⬜⬛⬛⬛⬜⬜⬜⬜⬜⬜⬜
⬜⬛⬛⬛⬜⬜⬛⬜⬜⬛⬛⬛⬛⬜⬛⬛⬛⬜⬛⬛⬛⬛⬜⬛⬛⬛⬜⬜⬛⬛⬜⬜⬛⬛⬛⬜⬛⬛⬛⬛⬜⬛⬛⬛⬛⬛⬜⬛⬛⬛⬛⬛⬛⬛⬜
⬜⬜⬜⬛⬛⬛⬜⬛⬛⬜⬛⬜⬛⬛⬜⬛⬜⬛⬛⬛⬛⬛⬜⬛⬛⬜⬛⬛⬜⬛⬛⬛⬛⬜⬛⬜⬛⬜⬜⬜⬛⬜⬛⬛⬛⬛⬜⬛⬜⬛⬜⬜⬜⬜⬜
⬜⬜⬛⬛⬛⬛⬜⬜⬛⬜⬛⬜⬛⬜⬛⬛⬛⬛⬛⬜⬛⬛⬛⬜⬛⬜⬛⬛⬜⬜⬜⬜⬜⬛⬛⬛⬛⬜⬛⬛⬜⬛⬛⬛⬛⬜⬜⬛⬜⬛⬜⬛⬛⬛⬜
⬜⬛⬛⬛⬛⬜⬛⬜⬛⬛⬜⬜⬛⬜⬛⬜⬜⬜⬜⬛⬜⬛⬛⬛⬛⬜⬜⬜⬛⬛⬛⬛⬛⬜⬛⬜⬜⬛⬜⬛⬛⬛⬜⬜⬜⬜⬛⬛⬜⬛⬜⬛⬜⬜⬜
⬜⬜⬜⬛⬛⬛⬛⬜⬜⬛⬜⬛⬛⬜⬛⬜⬛⬜⬜⬛⬜⬛⬜⬜⬛⬛⬛⬛⬛⬜⬛⬛⬜⬜⬜⬛⬛⬛⬜⬛⬜⬛⬛⬛⬛⬛⬜⬛⬛⬛⬜⬛⬜⬜⬜
⬜⬜⬛⬜⬜⬛⬜⬜⬛⬛⬜⬜⬜⬛⬛⬛⬛⬛⬛⬛⬛⬜⬜⬜⬛⬜⬜⬛⬛⬛⬜⬜⬛⬛⬛⬛⬛⬛⬛⬜⬜⬛⬜⬜⬜⬛⬜⬛⬜⬛⬛⬛⬛⬜⬜
⬜⬜⬜⬜⬜⬜⬜⬜⬜⬜⬜⬜⬜⬜⬜⬜⬜⬜⬜⬜⬜⬜⬜⬜⬜⬜⬜⬜⬜⬜⬜⬜⬜⬜⬜⬜⬜⬜⬜⬜⬜⬜⬜⬜⬜⬜⬜⬜⬜⬜⬜⬜⬜⬜⬜
