⬜⬜⬜⬜⬜⬜⬜⬜⬜⬜⬜⬜⬜⬜⬜⬜⬜⬜⬜⬜⬜⬜⬜⬜⬜⬜⬜⬜⬜⬜⬜⬜⬜⬜⬜⬜⬜⬜⬜⬜⬜⬜⬜⬜⬜⬜⬜⬜⬜⬜⬜⬜⬜⬜⬜
⬜⬛⬛⬜⬜⬛⬛⬜⬛⬜⬛⬛⬛⬛⬜⬛⬛⬜⬛⬜⬛⬛⬜⬛⬜⬜⬜⬛⬛⬛⬜⬛⬜⬛⬜⬜⬛⬛⬛⬜⬛⬛⬛⬜⬛⬜⬛⬛⬛⬜⬜⬛⬛⬛⬜
⬜⬜⬛⬜⬛⬛⬜⬛⬛⬛⬛⬛⬛⬜⬛⬜⬛⬛⬜⬛⬛⬛⬜⬛⬛⬛⬛⬜⬜⬛⬛⬜⬛⬜⬛⬛⬛⬜⬛⬛⬛⬜⬜⬜⬛⬜⬜⬜⬜⬛⬛⬛⬛⬛⬜
⬜⬛⬛⬜⬛⬛⬛⬛⬛⬛⬜⬜⬜⬛⬛⬛⬛⬜⬛⬜⬛⬛⬜⬜⬛⬛⬛⬛⬛⬛⬜⬜⬛⬛⬛⬛⬛⬜⬜⬛⬛⬛⬛⬛⬜⬛⬛⬛⬛⬜⬛⬛⬛⬛⬜
⬜⬛⬛⬜⬛⬜⬜⬛⬛⬜⬛⬛⬜⬛⬛⬜⬛⬛⬛⬜⬜⬛⬛⬜⬛⬛⬛⬛⬜⬜⬛⬜⬛⬜⬛⬛⬛⬛⬛⬛⬛⬜⬛⬛⬜⬜⬜⬜⬛⬜⬛⬜⬛⬜⬜
⬜⬛⬛⬜⬛⬜⬛⬜⬛⬛⬜⬜⬜⬛⬜⬜⬛⬛⬛⬜⬛⬜⬜⬛⬜⬜⬜⬜⬛⬛⬜⬛⬛⬛⬜⬜⬜⬛⬛⬛⬛⬛⬜⬜⬛⬛⬛⬛⬛⬜⬛⬜⬜⬛⬜
⬜⬛⬛⬜⬛⬜⬛⬛⬛⬛⬛⬛⬜⬛⬜⬛⬜⬜⬜⬜⬛⬛⬛⬜⬛⬛⬛⬛⬛⬜⬛⬛⬛⬛⬛⬛⬛⬜⬛⬛⬛⬛⬛⬛⬜⬛⬜⬛⬜⬛⬛⬛⬛⬛⬜
⬜⬜⬛⬜⬛⬛⬛⬛⬛⬛⬛⬛⬛⬛⬛⬜⬛⬛⬛⬛⬜⬛⬛⬜⬛⬛⬜⬜⬛⬜⬛⬛⬛⬛⬛⬜⬜⬛⬛⬛⬜⬜⬜⬜⬛⬛⬜⬛⬛⬜⬛⬛⬛⬜⬜
⬜⬛⬛⬜⬛⬛⬛⬛⬛⬛⬜⬛⬜⬛⬛⬛⬜⬜⬛⬜⬛⬛⬛⬜⬛⬜⬛⬜⬛⬛⬛⬛⬛⬛⬜⬛⬜⬜⬜⬜⬛⬛⬛⬛⬜⬜⬜⬜⬛⬜⬛⬜⬜⬛⬜
⬜⬜⬛⬜⬛⬛⬛⬛⬜⬜⬜⬛⬜⬜⬛⬜⬜⬛⬛⬜⬜⬜⬛⬜⬛⬛⬛⬜⬛⬜⬜⬜⬛⬜⬛⬛⬜⬛⬛⬜⬜⬜⬜⬜⬛⬛⬛⬛⬜⬛⬛⬜⬛⬛⬜
⬜⬛⬜⬛⬜⬛⬛⬛⬛⬛⬛⬛⬜⬛⬛⬛⬛⬛⬛⬜⬛⬛⬜⬛⬜⬜⬜⬛⬛⬜⬛⬜⬛⬜⬛⬜⬜⬛⬜⬛⬛⬛⬛⬛⬜⬛⬛⬛⬛⬜⬛⬜⬛⬛⬜
⬜⬜⬜⬛⬛⬜⬛⬛⬛⬛⬛⬛⬜⬛⬜⬜⬜⬜⬛⬜⬛⬛⬜⬛⬛⬛⬛⬛⬛⬛⬛⬜⬛⬜⬛⬜⬛⬛⬜⬛⬛⬛⬛⬛⬛⬛⬜⬜⬜⬛⬛⬜⬜⬛⬜
⬜⬛⬛⬛⬜⬜⬛⬛⬛⬛⬛⬛⬜⬜⬛⬛⬛⬛⬜⬛⬛⬛⬜⬜⬛⬛⬛⬛⬛⬛⬛⬜⬛⬜⬛⬛⬛⬜⬛⬜⬛⬜⬛⬜⬜⬜⬜⬛⬛⬜⬛⬛⬛⬛⬜
⬜⬜⬛⬛⬛⬜⬛⬛⬛⬜⬜⬜⬛⬛⬜⬛⬜⬛⬛⬛⬛⬜⬛⬛⬜⬛⬜⬛⬛⬛⬛⬜⬜⬛⬛⬜⬜⬛⬜⬛⬛⬜⬜⬛⬛⬛⬜⬛⬜⬜⬛⬜⬜⬛⬜
⬜⬛⬛⬜⬛⬜⬛⬜⬜⬜⬛⬛⬛⬜⬛⬜⬜⬛⬜⬛⬜⬛⬜⬛⬛⬜⬛⬜⬜⬜⬜⬛⬛⬛⬜⬜⬛⬛⬛⬛⬜⬛⬛⬛⬜⬛⬜⬛⬛⬛⬛⬜⬛⬛⬜
⬜⬛⬛⬜⬛⬜⬛⬜⬛⬛⬛⬛⬛⬜⬛⬜⬛⬛⬜⬜⬛⬜⬛⬛⬛⬛⬛⬛⬛⬛⬛⬛⬜⬛⬛⬛⬛⬜⬜⬛⬜⬛⬛⬜⬛⬛⬛⬜⬜⬜⬜⬛⬜⬛⬜
⬜⬛⬛⬛⬜⬛⬛⬛⬛⬜⬜⬜⬜⬛⬛⬛⬜⬛⬛⬛⬛⬜⬛⬜⬜⬜⬜⬜⬜⬜⬜⬜⬜⬜⬛⬜⬛⬜⬛⬛⬛⬜⬛⬜⬛⬜⬛⬛⬛⬛⬜⬛⬜⬛⬜
⬜⬛⬛⬜⬛⬜⬜⬜⬜⬛⬛⬛⬜⬛⬛⬛⬜⬛⬜⬜⬛⬜⬛⬜⬛⬛⬛⬛⬛⬛⬛⬛⬛⬛⬛⬜⬛⬛⬜⬛⬜⬛⬛⬜⬛⬜⬛⬛⬛⬛⬜⬛⬛⬛⬜
⬜⬛⬛⬜⬛⬛⬛⬛⬜⬛⬜⬛⬛⬛⬜⬛⬜⬛⬛⬛⬛⬜⬜⬛⬛⬜⬜⬛⬛⬜⬜⬜⬜⬛⬛⬛⬜⬛⬜⬛⬜⬛⬜⬛⬛⬛⬜⬛⬛⬛⬜⬛⬜⬜⬜
⬜⬜⬛⬜⬛⬜⬜⬜⬛⬜⬜⬛⬛⬛⬜⬛⬛⬜⬜⬛⬛⬛⬛⬜⬛⬜⬛⬛⬛⬛⬛⬛⬛⬛⬜⬜⬛⬜⬛⬜⬛⬛⬜⬛⬜⬜⬛⬜⬛⬜⬛⬛⬜⬛⬜
⬜⬜⬛⬛⬛⬜⬛⬛⬛⬜⬛⬛⬛⬜⬜⬛⬜⬛⬛⬜⬛⬜⬜⬜⬛⬜⬜⬜⬜⬛⬜⬜⬜⬛⬜⬛⬛⬛⬛⬛⬜⬜⬛⬜⬛⬛⬛⬜⬛⬜⬛⬜⬛⬜⬜
⬜⬛⬜⬛⬜⬜⬛⬜⬛⬜⬛⬛⬛⬛⬜⬜⬜⬛⬜⬛⬜⬛⬛⬛⬜⬛⬛⬛⬛⬛⬜⬛⬛⬜⬛⬜⬛⬛⬛⬛⬛⬜⬛⬜⬜⬛⬛⬜⬛⬜⬛⬛⬛⬛⬜
⬜⬛⬜⬛⬜⬛⬛⬛⬜⬛⬛⬛⬛⬛⬛⬛⬛⬛⬜⬜⬛⬜⬛⬛⬛⬜⬜⬛⬜⬛⬜⬜⬜⬛⬛⬜⬜⬛⬛⬜⬛⬜⬜⬛⬛⬜⬛⬛⬜⬛⬜⬜⬛⬜⬜
⬜⬜⬛⬛⬜⬜⬜⬜⬛⬛⬛⬛⬛⬜⬜⬜⬜⬜⬛⬛⬜⬛⬜⬜⬜⬛⬜⬛⬜⬛⬛⬛⬛⬜⬛⬜⬛⬜⬛⬜⬛⬛⬜⬛⬛⬜⬜⬛⬛⬛⬜⬛⬜⬛⬜
⬜⬛⬜⬛⬛⬛⬛⬛⬛⬜⬛⬛⬛⬛⬜⬛⬜⬛⬛⬜⬜⬛⬜⬛⬛⬛⬜⬛⬜⬜⬛⬛⬜⬜⬛⬜⬛⬜⬛⬜⬜⬛⬛⬜⬛⬜⬛⬜⬜⬛⬜⬛⬛⬛⬜
⬜⬛⬛⬜⬜⬜⬛⬜⬛⬛⬜⬜⬛⬛⬛⬛⬜⬛⬜⬛⬛⬛⬛⬜⬜⬛⬛⬛⬛⬛⬛⬜⬛⬜⬛⬛⬛⬜⬛⬜⬛⬛⬛⬜⬛⬛⬛⬜⬛⬛⬜⬛⬜⬜⬜
⬜⬜⬛⬛⬛⬛⬛⬜⬜⬛⬜⬛⬛⬜⬛⬛⬜⬛⬛⬜⬛⬜⬜⬛⬜⬛⬜⬜⬛⬛⬛⬛⬜⬛⬛⬜⬜⬛⬜⬛⬜⬛⬜⬜⬛⬜⬛⬛⬜⬛⬛⬛⬛⬜⬜
⬜⬛⬛⬜⬜⬜⬛⬛⬜⬛⬜⬛⬜⬜⬛⬛⬜⬜⬛⬜⬛⬜⬛⬜⬛⬜⬜⬛⬛⬛⬛⬛⬜⬛⬜⬛⬜⬛⬛⬛⬛⬛⬛⬛⬜⬛⬛⬛⬜⬜⬛⬛⬜⬜⬜
⬜⬛⬜⬛⬛⬛⬛⬛⬜⬛⬜⬛⬛⬜⬜⬛⬛⬜⬛⬜⬛⬛⬛⬜⬛⬜⬛⬛⬛⬛⬛⬛⬛⬛⬛⬛⬛⬜⬜⬜⬜⬛⬜⬛⬛⬜⬛⬛⬛⬛⬜⬛⬛⬛⬜
⬜⬛⬜⬛⬜⬛⬛⬛⬜⬛⬜⬛⬜⬛⬛⬜⬛⬛⬛⬜⬛⬜⬜⬛⬜⬛⬜⬛⬛⬛⬛⬛⬛⬜⬛⬜⬛⬛⬛⬛⬛⬛⬜⬜⬜⬛⬜⬜⬜⬜⬛⬜⬛⬛⬜
⬜⬛⬜⬛⬜⬛⬜⬛⬜⬛⬛⬛⬛⬜⬛⬜⬜⬜⬜⬛⬛⬛⬛⬛⬜⬛⬜⬜⬜⬛⬛⬛⬜⬜⬛⬜⬛⬜⬜⬛⬜⬛⬛⬛⬛⬛⬛⬛⬛⬛⬛⬛⬜⬜⬜
⬜⬛⬜⬛⬜⬛⬜⬜⬜⬛⬜⬜⬛⬜⬛⬛⬛⬛⬛⬜⬜⬛⬜⬛⬜⬛⬜⬛⬛⬜⬛⬛⬛⬛⬛⬛⬛⬛⬜⬛⬜⬛⬛⬜⬜⬜⬜⬛⬜⬛⬜⬛⬜⬛⬜
⬜⬛⬜⬛⬛⬜⬛⬛⬛⬛⬛⬛⬜⬛⬛⬛⬜⬜⬛⬛⬛⬜⬛⬛⬛⬛⬜⬛⬜⬛⬜⬛⬜⬜⬛⬜⬜⬛⬛⬛⬛⬛⬛⬜⬛⬛⬛⭐⬜⬛⬜⬛⬜⬛⬜
⬜⬜⬛⬜⬛⬛⬜⬛⬜⬜⬜⬛⬛⬛⬜⬛⬛⬛⬛⬛⬛⬛⬛⬜⬛⬛⬜⬛⬜⬛⬜⬛⬛⬜⬛⬜⬛⬜⬜⬜⬜⬛⬛⬛⬜⬜⬜⬛⬜⬛⬜⬛⬜⬜⬜
⬜⬛⬛⬜⬛⬜⬛⬜⬛⬛⬛⬜⬛⬛⬜⬜⬜⬜⬛⬜⬜⬜⬛⬜⬛⬜⬜⬛⬛⬛⬜⬜⬜⬜⬛⬛⬛⬜⬛⬛⬛⬛⬛⬜⬛⬛⬛⬜⬛⬛⬜⬛⬛⬛⬜
⬜⬛⬛⬜⬛⬛⬛⬛⬜⬛⬜⬜⬛⬜⬛⬛⬛⬛⬛⬜⬛⬜⬛⬜⬛⬛⬜⬛⬛⬜⬛⬛⬛⬛⬛⬜⬛⬛⬜⬛⬜⬜⬛⬜⬛⬛⬛⬜⬛⬜⬛⬜⬛⬜⬜
⬜⬜⬜⬛⬛⬛⬛⬜⬜⬛⬜⬛⬛⬛⬜⬜⬜⬜⬛⬛⬛⬛⬛⬜⬛⬜⬛⬛⬜⬜⬛⬛⬜⬜⬜⬜⬛⬜⬜⬛⬛⬛⬛⬜⬛⬛⬛⬜⬛⬜⬛⬛⬛⬛⬜
⬜⬛⬛⬜⬜⬛⬛⬛⬛⬛⬛⬛⬛⬛⬜⬛⬛⬛⬜⬜⬜⬜⬛⬛⬛⬜⬜⬛⬛⬛⬛⬜⬜⬛⬛⬛⬛⬛⬛⬛⬜⬜⬜⬛⬜⬜⬛⬜⬛⬜⬜⬛⬜⬜⬜
⬜⬜⬛⬜⬛⬜⬜⬜⬛⬜⬜⬛⬜⬛⬛⬛⬜⬜⬛⬛⬛⬛⬜⬛⬛⬛⬛⬛⬜⬜⬜⬛⬛⬛⬜⬜⬜⬜⬜⬛⬛⬛⬛⬛⬜⬛⬜⬜⬛⬛⬛⬛⬛⬛⬜
⬜⬛⬜⬛⬜⬛⬛⬛⬛⬜⬛⬛⬜⬛⬜⬛⬛⬛⬛⬛⬜⬛⬜⬜⬜⬜⬛⬛⬜⬛⬛⬛⬜⬛⬜⬛⬛⬛⬜⬛⬜⬜⬜⬛⬜⬛⬛⬛⬜⬜⬜⬛⬛⬜⬜
⬜⬜⬛⬛⬛⬜⬜⬛⬛⬜⬛⬜⬜⬛⬜⬜⬜⬛⬜⬜⬛⬛⬛⬛⬛⬛⬛⬜⬛⬛⬛⬛⬜⬛⬛⬛⬛⬜⬜⬛⬛⬛⬛⬛⬛⬛⬜⬜⬛⬜⬛⬛⬜⬛⬜
⬜⬛⬛⬛⬛⬛⬜⬛⬛⬜⬜⬛⬛⬜⬛⬛⬛⬛⬛⬛⬛⬛⬜⬜⬜⬜⬜⬛⬜⬛⬛⬛⬛⬛⬛⬜⬛⬜⬛⬜⬜⬜⬜⬜⬜⬛⬛⬜⬛⬜⬛⬜⬜⬜⬜
⬜⬛⬛⬜⬜⬛⬜⬛⬛⬛⬜⬛⬜⬛⬜⬜⬜⬜⬜⬛⬛⬛⬜⬛⬛⬛⬛⬛⬛⬜⬛⬜⬜⬛⬛⬜⬛⬜⬛⬛⬛⬛⬛⬛⬛⬜⬛⬜⬛⬜⬛⬛⬛⬛⬜
⬜⬛⬛⬜⬛⬜⬜⬛⬛⬛⬜⬛⬜⬛⬜⬛⬜⬛⬜⬛⬛⬜⬛⬜⬜⬜⬜⬛⬛⬜⬛⬜⬛⬜⬛⬛⬛⬜⬜⬛⬛⬛⬜⬜⬛⬛⬛⬜⬛⬜⬜⬜⬜⬛⬜
⬜⬛⬛⬜⬛⬛⬛⬛⬜⬛⬜⬛⬜⬛⬛⬛⬜⬛⬛⬜⬛⬜⬛⬛⬛⬛⬛⬛⬛⬛⬛⬜⬛⬜⬛⬜⬜⬛⬛⬜⬛⬛⬛⬛⬛⬛⬛⬜⬛⬛⬛⬜⬛⬛⬜
⬜⬛⬛⬛⬜⬜⬛⬛⬜⬛⬜⬛⬜⬛⬜⬛⬜⬜⬛⬜⬛⬜⬜⬛⬛⬜⬛⬛⬜⬜⬜⬛⬛⬛⬛⬜⬛⬛⬜⬛⬜⬛⬛⬛⬛⬛⬛⬛⬛⬜⬛⬛⬜⬛⬜
⬜⬛⬜⬛⬜⬛⬛⬜⬛⬛⬛⬜⬛⬜⬛⬜⬛⬛⬛⬛⬛⬜⬛⬛⬛⬜⬛⬜⬛⬛⬛⬜⬜⬜⬛⬛⬛⬜⬜⬛⬛⬜⬜⬛⬛⬜⬛⬜⬜⬜⬛⬜⬛⬜⬜
⬜⬜⬜⬛⬜⬛⬛⬛⬜⬜⬛⬜⬛⬛⬜⬜⬛⬜⬛⬛⬛⬛⬛⬜⬛⬜⬛⬜⬛⬛⬜⬜⬛⬛⬛⬜⬛⬛⬛⬜⬜⬛⬛⬛⬛⬜⬛⬛⬛⬛⬛⬜⬛⬛⬜
⬜⬜⬛⬜⬛⬛*️⃣⬛⬛⬛⬛⬛⬜⬛⬛⬛⬜⬛⬛⬛⬛⬛⬛⬜⬛⬜⬛⬜⬜⬛⬛⬛⬜⬜⬛⬜⬜⬛⬜⬛⬛⬛⬛⬜⬛⬜⬛⬛⬛⬜⬛⬜⬛⬛⬜
⬜⬛⬛⬛⬛⬛⬛⬛⬛⬛⬛⬛⬛⬜⬜⬜⬜⬛⬜⬜⬜⬛⬜⬛⬛⬜⬛⬛⬛⬜⬜⬛⬛⬛⬛⬜⬛⬛⬛⬜⬜⬜⬛⬜⬜⬜⬛⬛⬛⬜⬛⬜⬛⬛⬜
⬜⬛⬜⬜⬜⬜⬜⬜⬜⬛⬛⬛⬛⬛⬛⬛⬛⬜⬛⬛⬛⬛⬜⬜⬜⬛⬛⬜⬜⬛⬛⬛⬜⬛⬜⬛⬜⬛⬛⬜⬛⬛⬛⬛⬛⬛⬛⬛⬛⬜⬛⬜⬛⬜⬜
⬜⬜⬛⬛⬜⬛⬛⬜⬛⬛⬛⬜⬜⬛⬛⬜⬜⬛⬜⬛⬜⬜⬛⬛⬜⬛⬜⬛⬛⬜⬜⬛⬜⬛⬜⬛⬛⬜⬛⬜⬜⬜⬜⬜⬛⬜⬜⬛⬛⬜⬛⬜⬛⬜⬜
⬜⬜⬜⬛⬜⬛⬛⬛⬛⬛⬛⬜⬛⬛⬛⬛⬛⬛⬜⬛⬛⬛⬜⬛⬛⬜⬜⬜⬜⬛⬛⬛⬛⬛⬜⬛⬜⬜⬛⬜⬛⬛⬛⬛⬛⬛⬛⬜⬛⬛⬛⬛⬛⬛⬜
⬜⬛⬜⬛⬛⬜⬜⬜⬜⬜⬛⬜⬛⬜⬜⬜⬜⬛⬛⬜⬜⬜⬛⬛⬛⬛⬛⬛⬛⬜⬛⬜⬛⬜⬛⬛⬛⬛⬜⬜⬛⬛⬛⬛⬜⬜⬜⬛⬜⬛⬛⬜⬜⬜⬜
⬜⬜⬜⬜⬜⬜⬜⬜⬜⬜⬜⬜⬜⬜⬜⬜⬜⬜⬜⬜⬜⬜⬜⬜⬜⬜⬜⬜⬜⬜⬜⬜⬜⬜⬜⬜⬜⬜⬜⬜⬜⬜⬜⬜⬜⬜⬜⬜⬜⬜⬜⬜⬜⬜⬜
