⬜⬜⬜⬜⬜⬜⬜⬜⬜⬜⬜⬜⬜⬜⬜⬜⬜⬜⬜⬜⬜⬜⬜⬜⬜⬜⬜⬜⬜⬜⬜⬜⬜⬜⬜⬜⬜⬜⬜⬜⬜⬜⬜⬜⬜⬜⬜⬜⬜⬜⬜⬜⬜⬜⬜
⬜⬛⬜⬛⬛⬛⬛⬛⬛⬛⬛⬛⬛⬜⬛⬜⬛⬛⬜⬜⬜⬛⬛⬛⬜⬜⬛⬛⬛⬜⬛⬜⬛⬛⬛⬛⬛⬜⬛⬛⬜⬛⬜⬛⬛⬛⬜⬛⬛⬛⬜⬛⬜⬜⬜
⬜⬛⬜⬛⬛⬛⬛⬛⬜⬛⬜⬜⬜⬛⬜⬛⬛⬜⬛⬛⬛⬛⬜⬜⬛⬛⬛⬜⬛⬜⬛⬜⬜⬜⬛⬜⬜⬛⬜⬛⬛⬛⬜⬛⬛⬛⬜⬜⬜⬛⬜⬛⬜⬛⬜
⬜⬛⬛⬜⬜⬜⬛⬜⬛⬜⬛⬛⬜⬛⬛⬜⬜⬜⬛⬜⬜⬛⬛⬜⬛⬛⬜⬛⬛⬛⬛⬜⬛⬛⬜⬛⬜⬛⬜⬛⬜⬜⬛⬛⬜⬜⬛⬛⬜⬜⬜⬛⬜⬛⬜
⬜⬛⬜⬛⬛⬜⬛⬛⬛⬜⬛⬛⬛⬛⬛⬛⬛⬛⬜⬛⬛⬛⬛⬜⬛⬜⬛⬛⬛⬛⬛⬜⬜⬜⬛⬛⬛⬛⬜⬛⬜⬛⬛⬜⬛⬛⬛⬛⬛⬛⬛⬛⬜⬛⬜
⬜⬜⬛⬜⬛⬛⬛⬛⬛⬛⬛⬜⬜⬜⬜⬛⬛⬛⬜⬜⬛⬜⬜⬛⬜⬛⬛⬛⬛⬛⬛⬛⬛⬜⬛⬛⬛⬛⬜⬛⬛⬛⬜⬛⬛⬛⬜⬜⬜⬜⬛⬜⬛⬛⬜
⬜⬜⬜⬜⬜⬛⬜⬛⬜⬛⬛⬛⬛⬛⬛⬜⬛⬛⬛⬜⬛⬛⬛⬛⬛⬜⬜⬜⬜⬛⬜⬜⬜⬜⬛⬜⬛⬛⬛⬜⬛⬜⬛⬛⬛⬛⬛⬛⬛⬛⬛⬛⬜⬜⬜
⬜⬛⬛⬛⬛⬜⬛⬜⬛⬛⬛⬛⬜⬛⬛⬛⬛⬛⬛⬜⬛⬜⬜⬜⬜⬜⬛⬜⬜⬛⬛⬛⬛⬛⬛⬛⬜⬜⬜⬜⬛⬛⬛⬛⬛⬛⬛⬜⬛⬜⬛⬜⬛⬛⬜
⬜⬜⬜⬛⬜⬜⬛⬛⬛⬛⬜⬜⬜⬛⬛⬜⬛⬜⬜⬛⬛⬛⬛⬛⬛⬛⬛⬛⬛⬛⬜⬛⬜⬛⬛⬛⬛⬛⬛⬛⬛⬛⬛⬛⬛⬜⬜⬜⬛⬜⬛⬛⬛⬛⬜
⬜⬛⬛⬛⬛⬛⬜⬜⬜⬜⬛⬛⬛⬛⬜⬜⬛⬜⬜⬛⬛⬛⬛⬜⬛⬛⬛⬜⬜⬛⬜⬛⬜⬛⬛⬛⬜⬛⬛⬛⬛⬛⬛⬜⬜⬛⬛⬛⬛⬛⬛⬜⬜⬛⬜
⬜⬜⬜⬛⬜⬛⬛⬛⬛⬜⬛⬜⬛⬜⬛⬛⬛⬛⬛⬛⬛⬛⬛⬛⬜⬛⬛⬛⬜⬛⬜⬛⬛⬛⬜⬛⬜⬛⬛⬛⬛⬛⬛⬛⬛⬛⬛⬜⬜⬜⬜⬛⬛⬜⬜
⬜⭐⬛⬛⬛⬜⬛⬛⬛⬛⬛⬜⬛⬜⬜⬜⬜⬜⬜⬜⬜⬜⬜⬜⬜⬛⬛⬛⬜⬜⬜⬜⬛⬜⬜⬛⬜⬛⬛⬛⬜⬜⬜⬛⬜⬜⬜⬛⬛⬛⬛⬜⬛⬜⬜
⬜⬛⬜⬜⬜⬛⬛⬛⬛⬛⬜⬛⬛⬛⬜⬛⬛⬛⬛⬛⬛⬛⬛⬛⬛⬜⬜⬛⬛⬛⬛⬜⬛⬛⬛⬛⬛⬛⬜⬛⬛⬛⬛⬛⬛⬛⬛⬜⬛⬛⬜⬛⬛⬜⬜
⬜⬛⬜⬛⬜⬛⬛⬛⬛⬛⬜⬛⬜⬛⬛⬛⬜⬛⬜⬛⬜⬜⬛⬛⬜⬛⬜⬜⬛⬜⬛⬜⬛⬛⬛⬛⬛⬜⬜⬛⬛⬛⬜⬜⬛⬜⬛⬛⬛⬜⬜⬛⬜⬜⬜
⬜⬛⬜⬛⬛⬛⬜⬜⬛⬛⬜⬛⬜⬛⬛⬛⬛⬜⬛⬛⬜⬛⬜⬛⬜⬛⬛⬛⬛⬜⬛⬜⬛⬛⬛⬜⬛⬛⬛⬛⬛⬛⬛⬛⬛⬛⬜⬜⬜⬛⬛⬛⬛⬛⬜
⬜⬛⬜⬛⬛⬛⬜⬜⬛⬛⬜⬛⬛⬛⬜⬛⬛⬜⬛⬜⬛⬛⬜⬛⬛⬜⬛⬛⬛⬛⬛⬛⬜⬛⬛⬜⬜⬜⬜⬜⬛⬛⬜⬛⬛⬛⬛⬛⬛⬛⬜⬛⬜⬜⬜
⬜⬛⬛⬛⬛⬛⬛⬛⬜⬜⬜⬜⬛⬜⬜⬜⬜⬜⬜⬛⬜⬛⬛⬜⬛⬛⬜⬛⬛⬜⬜⬜⬛⬜⬜⬛⬛⬛⬛⬛⬛⬜⬜⬛⬜⬛⬛⬜⬜⬜⬛⬜⬛⬜⬜
⬜⬛⬜⬜⬜⬜⬜⬛⬛⬜⬛⬛⬜⬛⬛⬛⬛⬛⬛⬛⬛⬜⬛⬛⬜⬜⬛⬛⬛⬛⬛⬛⬛⬛⬛⬛⬜⬜⬜⬜⬛⬜⬛⬛⬜⬜⬜⬛⬛⬛⬛⬛⬛⬛⬜
⬜⬛⬛⬜⬛⬛⬛⬜⬜⬛⬛⬛⬛⬜⬛⬜⬜⬜⬜⬜⬜⬜⬛⬜⬛⬛⬛⬜⬜⬜⬜⬜⬜⬛⬛⬛⬛⬛⬛⬛⬛⬛⬛⬜⬛⬛⬛⬛⬛⬛⬛⬛⬛⬜⬜
⬜⬜⬛⬛⬛⬛⬛⬛⬜⬛⬜⬜⬜⬛⬜⬜⬜⬛⬛⬜⬛⬛⬛⬜⬛⬜⬛⬛⬛⬛⬛⬛⬛⬛⬛⬛⬜⬜⬜⬜⬛⬛⬛⬛⬜⬜⬜⬛⬜⬛⬛⬛⬛⬛⬜
⬜⬛⬜⬜⬜⬜⬜⬜⬛⬛⬛⬜⬛⬜⬛⬛⬛⬛⬜⬛⬛⬜⬜⬛⬜⬛⬜⬜⬛⬛⬛⬜⬜⬜⬜⬜⬛⬜⬛⬛⬜⬛⬛⬜⬛⬛⬛⬜⬛⬛⬛⬜⬛⬛⬜
⬜⬛⬛⬛⬛⬛⬛⬛⬜⬛⬜⬛⬛⬜⬜⬛⬜⬜⬜⬛⬛⬛⬛⬛⬜⬛⬜⬛⬛⬛⬛⬜⬛⬛⬜⬛⬜⬛⬛⬜⬛⬜⬛⬜⬛⬛⬛⬜⬛⬛⬜⬛⬜⬛⬜
⬜⬜⬜⬜⬜⬛⬛⬛⬜⬜⬛⬜⬛⬛⬜⬛⬜⬛⬛⬛⬛⬛⬛⬜⬜⬜⬛⬛⬜⬜⬛⬛⬜⬛⬜⬛⬜⬛⬛⬛⬜⬛⬛⬛⬛⬛⬛⬜⬛⬜⬛⬜⬛⬜⬜
⬜⬛⬜⬛⬛⬛⬜⬛⬛⬜⬛⬜⬛⬜⬛⬛⬛⬛⬜⬜⬜⬛⬛⬛⬛⬛⬜⬛⬛⬛⬜⬛⬜⬛⬛⬛⬛⬛⬜⬜⬜⬛⬛⬛⬛⬜⬛⬛⬛⬜⬛⬛⬜⬜⬜
⬜⬜⬛⬛⬜⬜⬛⬜⬜⬛⬛⬜⬛⬛⬜⬜⬜⬜⬜⬛⬛⬜⬜⬜⬜⬛⬜⬛⬜⬛⬜⬛⬜⬜⬜⬜⬛⬛⬛⬛⬛⬛⬛⬛⬛⬛⬜⬜⬜⬛⬜⬛⬛⬜⬜
⬜⬛⬜⬛⬛⬜⬛⬛⬜⬛⬜⬜⬛⬜⬛⬛⬜⬛⬛⬛⬛⬛⬛⬛⬛⬜⬛⬜⬛⬜⬛⬛⬛⬛⬛⬛⬛⬛⬛⬛⬜⬜⬛⬜⬛⬜⬛⬛⬜⬛⬜⬛⬜⬛⬜
⬜⬛⬛⬛⬛⬜⬛⬜⬛⬜⬛⬛⬛⬛⬛⬛⬛⬜⬜⬛⬜⬜⬜⬜⬛⬜⬛⬛⬜⬛⬛⬜⬛⬛⬜⬛⬛⬛⬛⬛⬛⬛⬛⬜⬛⬜⬛⬛⬜⬛⬛⬛⬛⬜⬜
⬜⬜⬛⬜⬛⬛⬛⬜⬛⬛⬛⬜⬜⬛⬛⬛⬜⬛⬜⬛⬛⬛⬛⬛⬛⬜⬜⬛⬜⬛⬜⬛⬜⬜⬛⬜⬛⬜⬜⬛⬛⬛⬛⬜⬛⬜⬛⬜⬛⬛⬛⬛⬜⬛⬜
⬜⬜⬛⬜⬜⬛⬜⬛⬜⬜⬜⬜⬛⬛⬛⬛⬛⬛⬜⬛⬜⬛⬜⬛⬜⬛⬜⬛⬛⬛⬜⬛⬛⬛⬛⬜⬛⬛⬛⬛⬛⬛⬛⬜⬛⬜⬜⬛⬜⬜⬛⬛⬛⬛⬜
⬜⬜⬜⬛⬛⬛⬛⬜⬛⬛⬛⬛⬜⬜⬛⬜⬛⬜⬛⬜⬛⬛⬜⬜⬛⬛⬜⬛⬜⬛⬛⬛⬜⬜⬜⬜⬛⬛⬛⬛⬛⬜⬜⬛⬜⬛⬛⬛⬛⬛⬛⬜⬛⬛⬜
⬜⬜⬛⬛⬜⬛⬜⬛⬛⬜⬛⬜⬛⬛⬛⬜⬛⬛⬜⬛⬛⬛⬛⬜⬛⬛⬛⬛⬛⬜⬜⬛⬜⬛⬛⬛⬜⬜⬜⬜⬛⬛⬛⬛⬛⬛⬛⬜⬛⬜⬛⬜⬛⬛⬜
⬜⬜⬜⬜⬛⬛⬜⬛⬛⬜⬛⬜⬛⬜⬛⬛⬛⬛⬛⬜⬛⬛⬛⬛⬜⬛⬜⬜⬛⬜⬛⬜⬛⬛⬜⬜⬛⬛⬛⬛⬛⬜⬛⬛⬜⬜⬛⬜⬛⬜⬛⬛⬜⬜⬜
⬜⬛⬛⬛⬜⬛⬛⬜⬜⬜⬛⬛⬜⬛⬛⬜⬛⬛⬛⬜⬛⬜⬜⬛⬜⬛⬜⬛⬜⬜⬛⬜⬛⬜⬛⬜⬛⬜⬜⬜⬜⬛⬜⬛⬜⬛⬜⬛⬛⬜⬛⬛⬛⬛⬜
⬜⬛⬜⬛⬛⬛⬛⬛⬛⬜⬜⬛⬛⬛⬜⬜⬛⬛⬛⬜⬛⬜⬛⬛⬛⬛⬛⬛⬛⬛⬛⬜⬛⬛⬛⬛⬛⬛⬛⬛⬜⬛⬜⬛⬛⬛⬜⬛⬛⬜⬜⬛⬛⬛⬜
⬜⬛⬜⬜⬛⬛⬛⬛⬜⬛⬛⬛⬛⬜⬛⬜⬛⬜⬜⬛⬛⬛⬜⬜⬜⬜⬛⬛⬜⬜⬜⬛⬛⬜⬛⬛⬜⬜⬜⬛⬜⬛⬛⬛⬛⬜⬛⬜⬜⬛⬛⬛⬛⬛⬜
⬜⬛⬛⬛⬛⬜⬜⬜⬛⬛⬜⬛⬜⬛⬛⬛⬛⬛⬜⬛⬛⬛⬜⬛⬛⬜⬛⬜⬜⬛⬛⬛⬜⬜⬜⬛⬜⬛⬛⬜⬛⬜⬛⬛⬛⬜⬛⬛⬛⬜⬛⬜⬜⬜⬜
⬜⬛⬛⬛⬜⬛⬛⬛⬛⬜⬜⬛⬜⬛⬛⬜⬜⬛⬜⬛⬜⬜⬛⬛⬛⬛⬛⬜⬛⬛⬛⬛⬜⬛⬛⬛⬜⬛⬜⬛⬜⬜⬛⬜⬛⬜⬛⬜⬜⬜⬛⬛⬛⬛⬜
⬜⬛⬛⬛⬜⬛⬛⬜⬛⬜⬛⬛⬜⬛⬛⬛⬛⬛⬜⬜⬛⬛⬜⬜⬜⬛⬜⬛⬜⬛⬛⬛⬜⬛⬜⬜⬛⬛⬜⬛⬛⬛⬛⬜⬛⬜⬜⬛⬛⬜⬛⬜⬜⬛⬜
⬜⬛⬛⬛⬜⬛⬛⬛⬜⬜⬛⬛⬛⬜⬛⬛⬛⬛⬛⬛⬛⬜⬛⬛⬛⬛⬜⬛⬛⬜⬛⬛⬛⬜⬛⬛⬛⬛⬜⬛⬜⬜⬛⬛⬜⬛⬛⬛⬛⬜⬛⬛⬛⬛⬜
⬜⬛⬛⬛⬜⬛⬜⬛⬛⬜⬛⬜⬜⬛⬜⬛⬛⬛⬛⬜⬛⬜⬛⬜⬜⬜⬜⬜⬛⬜⬛⬛⬛⬛⬛⬜⬜⬜⬛⬛⬛⬛⬛⬛⬜⬛⬜⬜⬛⬜⬛⬜⬜⬛⬜
⬜⬛⬛⬛⬛⬜⬛⬛⬛⬜⬛⬛⬜⬛⬜⬜⬛⬜⬛⬜⬜⬜⬛⬛⬛⬛⬛⬛⬛⬜⬛⬜⬜⬜⬛⬜⬛⬛⬛⬛*️⃣⬛⬛⬜⬛⬛⬛⬛⬛⬛⬛⬛⬜⬛⬜
⬜⬜⬛⬛⬛⬛⬛⬛⬜⬜⬛⬜⬛⬛⬛⬜⬛⬜⬜⬛⬛⬛⬛⬜⬜⬜⬜⬜⬛⬛⬛⬛⬛⬛⬛⬛⬜⬜⬛⬛⬛⬛⬜⬛⬜⬜⬛⬛⬜⬜⬜⬛⬛⬛⬜
⬜⬛⬛⬜⬛⬜⬛⬛⬛⬛⬛⬛⬛⬛⬛⬛⬛⬛⬛⬛⬛⬛⬜⬛⬛⬛⬛⬛⬜⬜⬛⬛⬛⬜⬛⬜⬛⬜⬜⬜⬛⬛⬜⬛⬛⬜⬜⬛⬛⬛⬛⬛⬜⬜⬜
⬜⬛⬜⬜⬛⬜⬛⬛⬜⬛⬜⬜⬛⬛⬛⬛⬛⬜⬜⬛⬛⬛⬜⬛⬜⬜⬛⬜⬛⬛⬛⬜⬜⬜⬛⬜⬜⬛⬛⬛⬜⬜⬛⬜⬜⬛⬛⬜⬜⬜⬜⬜⬛⬜⬜
⬜⬜⬛⬜⬛⬛⬜⬜⬛⬜⬛⬛⬛⬜⬜⬛⬛⬜⬛⬜⬛⬜⬛⬛⬜⬛⬜⬛⬜⬜⬛⬛⬛⬛⬜⬛⬛⬜⬛⬜⬛⬜⬛⬜⬛⬜⬛⬜⬛⬛⬛⬛⬛⬛⬜
⬜⬛⬛⬜⬜⬛⬛⬛⬛⬛⬛⬛⬛⬛⬜⬛⬛⬛⬛⬜⬛⬜⬛⬜⬛⬛⬛⬛⬛⬛⬜⬜⬜⬜⬛⬜⬛⬜⬛⬛⬜⬛⬛⬛⬛⬛⬛⬛⬛⬜⬜⬜⬜⬛⬜
⬜⬛⬜⬛⬛⬛⬜⬜⬜⬜⬛⬛⬛⬛⬜⬜⬜⬜⬜⬛⬜⬜⬛⬛⬜⬛⬜⬛⬜⬛⬛⬛⬛⬛⬛⬜⬜⬛⬜⬜⬛⬛⬜⬜⬜⬜⬜⬛⬜⬛⬛⬛⬜⬛⬜
⬜⬛⬛⬜⬛⬜⬛⬛⬛⬛⬛⬛⬜⬜⬛⬛⬛⬛⬛⬜⬛⬛⬜⬜⬜⬛⬜⬛⬜⬜⬜⬜⬜⬛⬜⬛⬛⬛⬜⬛⬛⬜⬛⬛⬛⬛⬛⬜⬛⬛⬜⬛⬛⬛⬜
⬜⬜⬜⬜⬛⬛⬜⬜⬜⬛⬜⬛⬛⬜⬛⬛⬜⬜⬛⬛⬛⬜⬛⬛⬛⬜⬜⬛⬜⬛⬛⬛⬛⬜⬛⬜⬜⬛⬛⬜⬛⬜⬛⬛⬜⬜⬜⬛⬜⬛⬜⬛⬜⬜⬜
⬜⬛⬛⬛⬜⬛⬜⬛⬜⬛⬜⬜⬜⬛⬛⬜⬛⬜⬛⬛⬛⬜⬛⬛⬛⬜⬛⬛⬜⬜⬛⬛⬛⬛⬛⬛⬛⬜⬛⬜⬛⬜⬛⬛⬜⬛⬛⬜⬛⬛⬛⬛⬛⬛⬜
⬜⬛⬜⬛⬛⬛⬜⬛⬜⬛⬛⬛⬜⬛⬜⬜⬛⬛⬜⬛⬛⬜⬛⬜⬛⬜⬛⬛⬜⬛⬜⬛⬜⬛⬛⬜⬛⬛⬛⬜⬛⬛⬜⬜⬛⬜⬛⬜⬜⬜⬛⬛⬛⬜⬜
⬜⬛⬜⬛⬜⬜⬛⬜⬜⬛⬛⬜⬛⬛⬛⬛⬛⬜⬜⬛⬛⬜⬛⬜⬛⬜⬛⬜⬛⬛⬜⬛⬜⬜⬜⬜⬛⬜⬜⬜⬛⬛⬛⬜⬛⬜⬛⬛⬛⬛⬛⬛⬜⬛⬜
⬜⬜⬛⬛⬜⬛⬛⬛⬜⬜⬛⬜⬛⬜⬜⬜⬜⬜⬛⬜⬛⬛⬛⬜⬛⬛⬜⬛⬜⬛⬛⬛⬛⬛⬛⬛⬜⬛⬛⬛⬛⬜⬜⬛⬛⬜⬛⬜⬜⬜⬜⬛⬜⬛⬜
⬜⬜⬛⬜⬜⬛⬛⬛⬛⬛⬜⬛⬛⬜⬛⬛⬛⬛⬜⬛⬜⬜⬜⬛⬜⬛⬜⬛⬛⬜⬛⬛⬛⬛⬛⬜⬜⬛⬛⬜⬜⬛⬜⬛⬜⬛⬜⬜⬛⬛⬛⬛⬜⬛⬜
⬜⬜⬜⬜⬜⬜⬜⬜⬜⬜⬜⬜⬜⬜⬜⬜⬜⬜⬜⬜⬜⬜⬜⬜⬜⬜⬜⬜⬜⬜⬜⬜⬜⬜⬜⬜⬜⬜⬜⬜⬜⬜⬜⬜⬜⬜⬜⬜⬜⬜⬜⬜⬜⬜⬜
