⬜⬜⬜⬜⬜⬜⬜⬜⬜⬜⬜⬜⬜⬜⬜⬜⬜⬜⬜⬜⬜⬜⬜⬜⬜⬜⬜⬜⬜⬜⬜⬜⬜⬜⬜⬜⬜⬜⬜⬜⬜⬜⬜⬜⬜⬜⬜⬜⬜⬜⬜⬜⬜⬜⬜
⬜⬜⬛⬜⬜⬜⬜⬜⬜⬛⬛⬛⬛⬜⬛⬛⬛⬛⬛⬛⬜⬜⬛⬜⬛⬛⬜⬜⭐⬛⬛⬛⬛⬛⬛⬛⬛⬛⬛⬛⬛⬜⬛⬛⬜⬛⬛⬛⬜⬛⬜⬛⬛⬜⬜
⬜⬛⬛⬛⬛⬛⬛⬛⬛⬜⬛⬛⬜⬜⬛⬜⬜⬛⬜⬛⬜⬛⬜⬛⬜⬜⬛⬛⬜⬛⬜⬜⬛⬛⬛⬛⬜⬜⬜⬜⬜⬛⬛⬜⬛⬛⬛⬜⬜⬛⬛⬜⬛⬛⬜
⬜⬛⬜⬜⬛⬛⬛⬛⬜⬛⬛⬛⬛⬛⬛⬛⬛⬛⬜⬛⬜⬛⬜⬛⬛⬛⬜⬜⬜⬛⬜⬛⬛⬛⬜⬜⬛⬛⬛⬛⬛⬛⬜⬛⬛⬛⬛⬛⬛⬜⬛⬜⬛⬛⬜
⬜⬛⬜⬛⬛⬛⬛⬛⬜⬜⬜⬜⬜⬜⬜⬜⬜⬜⬛⬜⬛⬜⬛⬛⬜⬛⬜⬛⬛⬛⬜⬜⬜⬛⬛⬜⬜⬜⬜⬜⬛⬛⬜⬛⬜⬛⬜⬛⬜⬛⬛⬜⬛⬜⬜
⬜⬛⬜⬜⬛⬛⬜⬛⬛⬛⬛⬛⬛⬛⬛⬛⬛⬛⬛⬛⬛⬜⬛⬛⬜⬛⬛⬛⬜⬛⬜⬛⬛⬜⬛⬛⬛⬛⬛⬛⬛⬛⬜⬛⬜⬛⬜⬛⬛⬜⬜⬛⬛⬛⬜
⬜⬛⬛⬛⬜⬜⬜⬛⬛⬛⬛⬛⬛⬛⬛⬜⬛⬜⬛⬜⬜⬛⬜⬜⬜⬛⬛⬛⬜⬛⬛⬜⬜⬛⬜⬜⬜⬛⬛⬛⬛⬛⬜⬛⬜⬛⬜⬜⬜⬜⬛⬜⬜⬜⬜
⬜⬛⬛⬜⬛⬛⬛⬛⬛⬜⬜⬜⬛⬛⬛⬜⬛⬜⬛⬛⬛⬛⬛⬛⬛⬛⬜⬛⬜⬛⬛⬛⬜⬛⬛⬛⬛⬜⬜⬜⬜⬛⬜⬛⬛⬜⬛⬛⬛⬛⬛⬛⬛⬛⬜
⬜⬜⬛⬛⬜⬛⬛⬜⬜⬛⬛⬛⬛⬛⬛⬜⬛⬛⬛⬜⬜⬜⬜⬜⬜⬜⬛⬛⬛⬛⬛⬛⬛⬛⬜⬜⬜⬛⬛⬜⬛⬛⬛⬛⬜⬜⬛⬜⬛⬜⬜⬜⬛⬜⬜
⬜⬛⬛⬜⬛⬜⬛⬛⬛⬛⬛⬜⬛⬛⬛⬛⬜⬜⬛⬛⬛⬛⬛⬛⬛⬛⬜⬜⬜⬛⬜⬛⬛⬛⬜⬛⬛⬜⬛⬛⬛⬛⬛⬜⬛⬛⬜⬜⬛⬜⬛⬛⬛⬜⬜
⬜⬛⬛⬜⬛⬜⬜⬜⬜⬜⬛⬜⬛⬛⬛⬛⬜⬛⬜⬜⬛⬛⬜⬛⬜⬜⬛⬛⬛⬛⬜⬛⬜⬜⬛⬛⬜⬛⬛⬛⬜⬛⬛⬛⬛⬛⬛⬛⬛⬛⬜⬜⬛⬜⬜
⬜⬜⬜⬜⬛⬜⬛⬛⬛⬛⬜⬛⬛⬛⬛⬛⬛⬛⬛⬛⬛⬜⬜⬜⬛⬜⬛⬜⬜⬛⬜⬛⬜⬛⬜⬛⬛⬜⬛⬛⬜⬛⬜⬜⬛⬜⬜⬛⬛⬛⬛⬛⬜⬛⬜
⬜⬛⬜⬛⬛⬛⬛⬛⬜⬜⬛⬛⬜⬜⬜⬜⬜⬜⬜⬜⬛⬛⬛⬛⬛⬜⬛⬛⬛⬛⬜⬛⬜⬛⬜⬛⬜⬜⬛⬛⬛⬜⬛⬛⬜⬛⬛⬛⬛⬛⬜⬛⬛⬛⬜
⬜⬛⬜⬛⬜⬜⬜⬜⬛⬛⬛⬜⬛⬜⬛⬛⬛⬛⬛⬛⬛⬛⬛⬜⬛⬜⬛⬜⬜⬛⬛⬜⬛⬛⬜⬛⬛⬛⬛⬜⬛⬜⬛⬛⬛⬜⬛⬛⬜⬜⬛⬜⬜⬜⬜
⬜⬛⬜⬜⬜⬛⬛⬛⬛⬜⬛⬛⬛⬛⬛⬜⬜⬜⬜⬜⬜⬛⬛⬜⬛⬜⬛⬛⬛⬛⬜⬛⬜⬛⬜⬛⬜⬜⬜⬜⬜⬛⬛⬛⬛⬜⬛⬜⬛⬛⬛⬛⬛⬛⬜
⬜⬛⬛⬛⬛⬛⬛⬛⬛⬜⬜⬛⬜⬛⬛⬜⬛⬛⬛⬜⬛⬛⬛⬜⬛⬛⬛⬜⬜⬛⬜⬛⬜⬛⬛⬛⬛⬛⬛⬛⬛⬛⬛⬛⬛⬜⬛⬜⬛⬜⬜⬜⬛⬛⬜
⬜⬛⬛⬜⬜⬜⬛⬛⬛⬜⬛⬛⬛⬜⬛⬛⬛⬜⬛⬛⬜⬛⬜⬜⬛⬜⬜⬛⬛⬛⬛⬛⬜⬜⬛⬜⬜⬜⬛⬜⬜⬛⬛⬛⬜⬛⬛⬜⬛⬛⬛⬛⬜⬛⬜
⬜⬛⬜⬛⬛⬛⬜⬛⬜⬜⬛⬜⬛⬜⬛⬛⬛⬛⬜⬜⬜⬛⬛⬛⬛⬛⬛⬛⬛⬜⬜⬛⬛⬜⬛⬛⬛⬛⬜⬛⬜⬜⬛⬛⬛⬜⬛⬛⬛⬛⬜⬛⬛⬜⬜
⬜⬛⬛⬛⬜⬛⬜⬛⬛⬛⬛⬜⬜⬛⬜⬛⬛⬛⬛⬛⬜⬛⬜⬜⬜⬛⬛⬛⬜⬛⬛⬛⬛⬜⬛⬜⬜⬜⬜⬛⬛⬜⬜⬛⬜⬛⬜⬛⬛⬛⬜⬜⬛⬜⬜
⬜⬜⬜⬛⬜⬛⬜⬛⬜⬜⬛⬛⬛⬛⬜⬛⬛⬛⬜⬜⬛⬛⬛⬛⬛⬜⬛⬛⬜⬛⬜⬜⬜⬜⬜⬛⬛⬛⬛⬛⬜⬛⬛⬛⬜⬛⬜⬛⬛⬛⬜⬛⬛⬜⬜
⬜⬛⬛⬛⬜⬛⬛⬛⬛⬛⬜⬛⬜⬛⬜⬜⬛⬛⬛⬜⬛⬜⬜⬛⬜⬜⬛⬛⬜⬛⬜⬛⬛⬜⬛⬛⬛⬛⬛⬛⬜⬜⬛⬛⬜⬛⬜⬜⬜⬛⬜⬛⬜⬛⬜
⬜⬜⬛⬜⬛⬜⬛⬜⬛⬛⬛⬛⬜⬛⬛⬛⬜⬛⬛⬛⬛⬛⬜⬛⬛⬛⬜⬛⬛⬛⬜⬛⬜⬛⬛⬛⬛⬛⬛⬛⬛⬛⬜⬛⬜⬛⬛⬛⬛⬜⬛⬛⬛⬛⬜
⬜⬜⬛⬛⬛⬜⬛⬛⬜⬜⬜⬛⬛⬛⬛⬛⬜⬛⬛⬜⬜⬜⬛⬜⬛⬛⬜⬛⬜⬛⬜⬛⬜⬛⬛⬜⬛⬜⬜⬛⬛⬛⬛⬜⬜⬛⬜⬜⬛⬛⬜⬜⬛⬜⬜
⬜⬜⬛⬛⬛⬛⬜⬛⬛⬛⬛⬜⬛⬛⬛⬛⬜⬛⬜⬛⬛⬛⬜⬛⬜⬛⬛⬛⬜⬛⬜⬜⬜⬜⬛⬜⬛⬜⬛⬜⬛⬛⬜⬛⬛⬛⬛⬛⬜⬜⬜⬛⬛⬜⬜
⬜⬛⬛⬛⬛⬛⬜⬛⬜⬜⬛⬜⬛⬛⬛⬛⬛⬛⬛⬜⬛⬛⬜⬛⬛⬜⬛⬛⬛⬜⬛⬛⬛⬛⬛⬛⬛⬛⬛⬜⬛⬜⬜⬛⬛⬜⬛⬜⬛⬛⬛⬜⬛⬜⬜
⬜⬜⬜⬜⬜⬛⬛⬛⬛⬜⬛⬜⬜⬛⬜⬛⬛⬜⬛⬛⬛⬛⬜⬛⬜⬜⬜⬛⬛⬜⬜⬛⬜⬜⬛⬛⬛⬜⬜⬛⬜⬛⬜⬜⬜⬛⬜⬛⬜⬛⬜⬛⬜⬛⬜
⬜⬜⬛⬛⬜⬛⬜⬜⬛⬛⬛⬛⬜⬛⬜⬛⬛⬜⬛⬛⬜⬜⬛⬜⬛⬜⬛⬛⬜⬜⬛⬛⬛⬛⬛⬜⬛⬜⬛⬛⬜⬛⬜⬛⬛⬛⬛⬜⬛⬛⬛⬛⬛⬛⬜
⬜⬛⬜⬛⬛⬛⬜⬛⬜⬜⬛⬛⬛⬛⬛⬛⬛⬛⬜⬛⬜⬛⬛⬜⬛⬛⬜⬛⬛⬛⬛⬛⬜⬜⬛⬜⬛⬛⬛⬜⬛⬛⬜⬜⬛⬜⬛⬜⬛⬜⬜⬜⬜⬜⬜
⬜⬜⬛⬛⬜⬜⬛⬛⬛⬜⬜⬛⬛⬛⬛⬛⬛⬛⬜⬛⬛⬜⬜⬜⬜⬛⬜⬛⬜⬛⬜⬜⬛⬜⬛⬜⬛⬜⬛⬜⬜⬜⬜⬛⬜⬜⬛⬜⬛⬛⬛⬛⬛⬛⬜
⬜⬜⬛⬜⬛⬜⬛⬜⬜⬛⬛⬜⬛⬛⬜⬛⬛⬛⬜⬛⬜⬛⬜⬛⬛⬛⬜⬛⬜⬛⬜⬛⬛⬛⬛⬜⬛⬜⬛⬛⬛⬛⬜⬛⬜⬛⬛⬛⬛⬜⬛⬛⬛⬛⬜
⬜⬛⬛⬛⬛⬛⬜⬛⬛⬛⬜⬛⬜⬛⬛⬜⬛⬛⬛⬛⬛⬜⬛⬛⬛⬜⬛⬛⬛⬛⬜⬛⬜⬜⬜⬛⬛⬜⬛⬜⬜⬛⬜⬛⬜⬛⬜⬛⬜⬜⬛⬜⬜⬛⬜
⬜⬛⬜⬛⬜⬛⬜⬛⬛⬜⬛⬛⬜⬛⬛⬜⬛⬛⬛⬛⬛⬜⬛⬜⬛⬛⬛⬜⬜⬛⬜⬛⬜⬛⬛⬜⬜⬛⬛⬛⬛⬛⬛⬛⬜⬛⬛⬜⬛⬛⬛⬛⬜⬛⬜
⬜⬜⬛⬛⬜⬛⬜⬛⬜⬛⬛⬜⬜⬛⬜⬜⬛⬛⬛⬛⬜⬛⬜⬜⬛⬜⬜⬜⬜⬛⬜⬛⬜⬛⬛⬜⬛⬛⬛⬜⬜⬛⬛⬛⬜⬛⬛⬜⬛⬜⬛⬜⬛⬜⬜
⬜⬜⬜⬛⬜⬛⬜⬛⬛⬛⬛⬛⬛⬛⬜⬛⬛⬛⬛⬜⬜⬛⬜⬛⬛⬛⬛⬛⬛⬛⬛⬛⬜⬛⬜⬛⬛⬛⬛⬛⬛⬛⬛⬜⬛⬛⬛⬜⬛⬜⬛⬜⬛⬜⬜
⬜⬜⬛⬛⬜⬛⬛⬜⬛⬜⬛⬛⬛⬜⬛⬜⬜⬛⬛⬛⬛⬛⬛⬛⬜⬛⬛⬜⬜⬜⬜⬛⬜⬛⬜⬛⬜⬛*️⃣⬛⬛⬛⬛⬛⬛⬜⬛⬛⬜⬛⬜⬛⬛⬛⬜
⬜⬛⬛⬛⬜⬛⬛⬜⬜⬜⬛⬛⬛⬜⬛⬛⬜⬛⬜⬜⬜⬜⬜⬜⬛⬜⬛⬜⬛⬛⬜⬛⬜⬜⬜⬛⬜⬛⬛⬛⬛⬛⬛⬛⬛⬛⬜⬛⬛⬛⬛⬛⬛⬛⬜
⬜⬛⬛⬜⬜⬛⬛⬛⬛⬛⬛⬜⬜⬛⬛⬛⬜⬛⬛⬛⬛⬛⬛⬛⬛⬜⬜⬛⬛⬜⬛⬜⬛⬛⬛⬛⬛⬜⬜⬜⬜⬛⬛⬜⬜⬛⬜⬛⬛⬛⬛⬛⬛⬛⬜
⬜⬛⬛⬛⬛⬜⬛⬜⬛⬛⬜⬛⬛⬛⬜⬜⬛⬛⬛⬛⬜⬜⬛⬛⬛⬜⬛⬛⬛⬛⬛⬜⬛⬛⬜⬛⬜⬛⬛⬛⬜⬛⬜⬛⬛⬛⬜⬜⬜⬛⬜⬛⬛⬛⬜
⬜⬜⬜⬛⬛⬛⬜⬜⬛⬜⬛⬛⬛⬛⬛⬜⬜⬛⬛⬛⬛⬛⬛⬛⬛⬛⬛⬛⬜⬜⬛⬛⬛⬛⬛⬜⬜⬛⬜⬜⬛⬛⬛⬜⬜⬜⬛⬛⬜⬜⬜⬛⬜⬛⬜
⬜⬛⬛⬛⬜⬜⬛⬛⬛⬛⬛⬛⬛⬛⬛⬛⬛⬛⬛⬛⬜⬜⬜⬛⬛⬛⬛⬛⬜⬛⬛⬜⬜⬜⬛⬛⬛⬛⬛⬛⬛⬜⬛⬜⬛⬜⬛⬜⬛⬛⬛⬜⬛⬜⬜
⬜⬜⬜⬛⬛⬜⬛⬜⬛⬛⬛⬛⬜⬜⬜⬜⬜⬛⬛⬛⬜⬛⬛⬛⬛⬛⬜⬛⬜⬛⬜⬛⬛⬜⬜⬜⬜⬛⬛⬜⬛⬜⬛⬜⬛⬛⬜⬛⬜⬜⬛⬜⬛⬜⬜
⬜⬜⬛⬜⬜⬜⬛⬜⬛⬜⬛⬛⬜⬛⬛⬛⬜⬛⬜⬜⬜⬛⬜⬛⬛⬛⬜⬛⬛⬛⬜⬛⬛⬛⬛⬛⬜⬛⬛⬜⬛⬛⬛⬜⬜⬛⬜⬛⬛⬛⬛⬜⬜⬛⬜
⬜⬜⬜⬛⬛⬛⬛⬜⬛⬛⬜⬛⬜⬜⬛⬛⬛⬜⬛⬛⬜⬛⬜⬛⬜⬛⬜⬜⬜⬛⬜⬛⬜⬜⬛⬜⬛⬛⬜⬛⬛⬜⬛⬛⬛⬛⬛⬜⬛⬜⬜⬛⬛⬜⬜
⬜⬜⬛⬛⬛⬛⬛⬛⬜⬜⬛⬛⬜⬛⬜⬜⬛⬛⬛⬛⬜⬛⬜⬛⬜⬛⬛⬛⬛⬛⬛⬛⬛⬛⬛⬜⬛⬜⬛⬛⬛⬜⬛⬜⬜⬜⬜⬛⬛⬛⬛⬛⬛⬜⬜
⬜⬜⬜⬛⬛⬛⬛⬛⬛⬛⬛⬛⬜⬛⬛⬜⬛⬛⬜⬛⬜⬛⬜⬜⬛⬜⬜⬛⬜⬛⬛⬛⬛⬛⬜⬜⬛⬜⬛⬜⬛⬜⬛⬛⬛⬛⬜⬛⬜⬜⬜⬜⬛⬜⬜
⬜⬛⬛⬛⬛⬛⬛⬛⬛⬛⬛⬛⬛⬛⬜⬜⬛⬜⬜⬛⬛⬜⬛⬛⬜⬛⬛⬛⬛⬜⬜⬜⬛⬛⬛⬛⬛⬜⬛⬜⬜⬛⬜⬛⬛⬛⬛⬛⬛⬛⬛⬛⬜⬛⬜
⬜⬜⬜⬜⬜⬜⬜⬛⬛⬛⬛⬛⬛⬛⬜⬛⬜⬜⬛⬜⬛⬜⬛⬛⬛⬛⬛⬜⬜⬛⬛⬜⬛⬛⬜⬜⬜⬜⬛⬜⬛⬛⬜⬛⬛⬛⬛⬛⬜⬜⬛⬜⬛⬛⬜
⬜⬛⬛⬛⬛⬛⬛⬛⬛⬜⬜⬛⬛⬛⬛⬛⬛⬛⬛⬜⬛⬜⬛⬜⬛⬜⬜⬛⬛⬜⬛⬛⬛⬜⬜⬛⬜⬛⬛⬛⬛⬛⬛⬛⬛⬛⬛⬛⬛⬜⬛⬜⬜⬜⬜
⬜⬜⬜⬜⬛⬜⬜⬛⬛⬜⬛⬜⬛⬜⬜⬜⬜⬜⬛⬜⬛⬜⬛⬜⬛⬜⬛⬜⬛⬛⬛⬛⬜⬛⬛⬛⬜⬛⬛⬛⬜⬜⬜⬛⬛⬛⬜⬜⬛⬛⬜⬛⬛⬛⬜
⬜⬛⬛⬜⬛⬛⬛⬛⬛⬜⬛⬛⬛⬛⬛⬛⬛⬛⬜⬛⬛⬛⬜⬛⬛⬜⬛⬛⬜⬛⬛⬜⬛⬛⬜⬛⬜⬛⬛⬛⬜⬛⬜⬛⬜⬛⬛⬜⬛⬜⬛⬜⬜⬛⬜
⬜⬜⬜⬛⬜⬛⬜⬜⬛⬛⬛⬛⬛⬛⬛⬛⬛⬜⬜⬛⬜⬛⬛⬜⬛⬜⬛⬛⬜⬛⬛⬜⬛⬛⬜⬛⬜⬛⬛⬛⬛⬛⬛⬜⬛⬜⬛⬛⬛⬜⬛⬜⬛⬛⬜
⬜⬜⬛⬜⬛⬜⬛⬛⬜⬜⬜⬛⬜⬛⬛⬛⬛⬛⬛⬜⬜⬛⬛⬜⬛⬛⬜⬜⬜⬛⬛⬛⬛⬛⬜⬛⬜⬛⬛⬛⬛⬛⬛⬛⬜⬜⬛⬜⬜⬛⬛⬛⬜⬜⬜
⬜⬜⬜⬜⬛⬜⬛⬜⬜⬛⬛⬜⬛⬛⬜⬜⬜⬜⬜⬛⬛⬛⬛⬜⬜⬛⬛⬛⬛⬛⬛⬜⬜⬛⬜⬛⬜⬛⬛⬛⬜⬜⬛⬜⬛⬛⬛⬜⬛⬜⬜⬜⬛⬜⬜
⬜⬛⬛⬛⬜⬛⬛⬜⬛⬛⬜⬛⬜⬛⬛⬛⬛⬛⬜⬛⬜⬛⬛⬛⬛⬛⬛⬛⬜⬛⬛⬛⬜⬜⬛⬛⬜⬜⬜⬜⬛⬛⬜⬛⬜⬜⬛⬛⬛⬛⬛⬜⬜⬛⬜
⬜⬜⬜⬜⬜⬜⬜⬜⬜⬜⬜⬜⬜⬜⬜⬜⬜⬜⬜⬜⬜⬜⬜⬜⬜⬜⬜⬜⬜⬜⬜⬜⬜⬜⬜⬜⬜⬜⬜⬜⬜⬜⬜⬜⬜⬜⬜⬜⬜⬜⬜⬜⬜⬜⬜
