⬛⬛⬜⬛⬛⬛⬜⬛⬜⬛⬛⬛⬜⬛⬛⬛⬛⬛⬛⬜⬛⬛⬛⬛⬛⬛⬛⬜⬛⬜⬛⬛⬛⬛⬛⬛⬛⬛⬛⬛⬛⬛⬛⬛⬜⬛⬛⬛⬜⬛⬛⬛⬛⬜⬛
⬛⬜⬛⬛⬛⬛⬛⬛⬜⬛⬛⬛⬜⬛⬛⬛⬛⬛⬛⬜⬛⬜⬜⬜⬛⬛⬜⬜⬛⬛⬜⬜⬛⬛⬛⬛⬛⬜⬜⬜⬜⬛⬛⬛⬜⬛⬜⬛⬜⬛⬛⬛⬛⬜⬛
⬜⬛⬛⬛⬛⬜⬜⬜⬜⬛⬜⬛⬜⬛⬛⬛⬛⬛⬛⬛⬜⬛⬛⬛⬛⬜⬛⬛⬜⬜⬛⬛⬛⬛⬛⬜⬛⬛⬛⬛⬜⬛⬛⬜⬛⬛⬜⬛⬜⬛⬛⬛⬜⬛⬛
⬛⬛⬛⬛⬛⬛⬛⬛⬛⬛⬜⬛⬛⬛⬜⬛⬜⬛⬛⬛⬛⬜⬜⬛⬛⬜⬛⬛⬛⬛⬜⬜⬜⬜⬛⬜⬜⬜⬛⬛⬜⬛⬛⬛⬜⬛⬜⬛⬜⬛⬜⬛⬛⬜⬛
⬛⬛⬛⬜⬛⬜⬛⬛⬛⬛⬛⬛⬜⬜⬜⬛⬜⬛⬛⬛⬛⬛⬛⬜⬛⬜⬛⬜⬜⬜⬜⬛⬛⬛⬛⬜⬛⬛⬛⬛⬜⬛⬜⬛⬛⬛⬛⬛⬜⬛⬜⬛⬛⬜⬛
⬛⬛⬜⬛⬛⬜⬛⬜⬛⬛⬛⬛⬛⬛⬛⬛⬛⬜⬛⬜⬜⬜⬛⬜⬛⬛⬜⬛⬜⬛⬛⬛⬛⬜⬛⬜⬛⬛⬜⬜⬜⬜⬜⬜⬜⬜⬜⬛⬜⬛⬛⬜⬛⬛⬛
⬛⬛⬛⬜⬛⬛⬛⬜⬜⬜⬛⬛⬛⬜⬜⬜⬛⬜⬜⬛⬛⬛⬛⬛⬛⬜⬜⬛⬛⬜⬜⬜⬛⬜⬛⬛⬛⬜⬜⬛⬛⬛⬛⬛⬛⬛⬛⬛⬛⬜⬜⬜⬜⬛⬛
⬛⬜⬜⬛⬜⬜⬛⬛⬛⬛⬜⬛⬛⬜⬛⬛⬜⬛⬛⬜⬛⬛⬛⬛⬛⬛⬜⬛⬜⬛⬛⬛⬜⬛⬛⬛⬛⬜⬛⬛⬜⬛⬛⬛⬜⬛⬜⬜⬛⬛⬛⬛⬜⬛⬜
⬜⬛⬜⬛⬜⬛⬜⬛⬜⬛⬜⬛⬜⬛⬛⬜⬛⬜⬛⬜⬛⬛⬛⬛⬛⬛⬜⬛⬛⬜⬜⬛⬛⬜⬛⬜⬛⬛⬛⬜⬜⬛⬜⬜⬛⬛⬜⬛⬜⬜⬜⬜⬛⬜⬛
⬜⬛⬜⬛⬜⬛⬜⬛⬜⬛⬜⬛⬜⬛⬜⬜⬛⬛⬛⬛⬛⬛⬛⬛⬛⬛⬛⬜⬜⬛⬜⬜⬜⬜⬜⬜⬜⬜⬛⬜⬛⬛⬛⬜⬛⬜⬜⬛⬛⬛⬛⬛⬛⬜⬛
⬜⬛⬜⬛⬛⬛⬛⬛⬛⬛⬜⬛⬜⬛⬛⬛⬜⬜⬛⬜⬜⬜⬜⬜⬛⬜⬛⬛⬜⬛⬛⬛⬛⬛⬛⬛⬛⬜⬛⬜⬛⬜⬛⬜⬜⬜⬛⬛⬜⬛⬜⬜⬛⬜⬛
⬛⬛⬜⬛⬜⬜⬜⬜⬜⬜⬜⬛⬜⬛⬜⬛⬛⬜⬛⬛⬛⬛⬛⬜⬛⬜⬛⬛⬛⬜⬜⬜⬛⬜⬛⬜⬛⬛⬛⬜⬛⬜⬛⬛⬛⬛⬜⬛⬜⬛⬜⬛⬛⬛⬛
⬜⬜⬜⬛⬜⬛⬛⬜⬛⬛⬛⬜⬛⬛⬛⬜⬛⬛⬛⬛⬜⬜⬛⬛⬛⬛⬜⬜⬛⬜⬛⬛⬛⬜⬛⬛⬜⬛⬜⬛⬛⬜⬛⬛⬛⬜⬜⬛⬜⬛⬛⬛⬜⬜⬜
⬛⬛⬛⬛⬜⬜⬛⬜⬛⬜⬜⬛⬛⬜⬛⬜⬛⬛⬛⬛⬛⬛⬛⬛⬛⬛⬛⬛⬛⬛⬜⬛⬛⬜⬛⬜⬛⬜⬛⬜⬛⬜⬛⬛⬛⬛⬜⬛⬜⬛⬜⬛⬛⬛⬛
⬛⬜⬛⬜⬛⬛⬛⬛⬛⬛⬜⬛⬜⬛⬛⬛⬛⬜⬜⬜⬛⬜⬛⬛⬛⬜⬜⬜⬜⬛⬜⬛⬛⬛⬜⬛⬛⬜⬛⬛⬛⬛⬛⬛⬛⬜⬛⬛⬜⬛⬜⬜⬛⬛⬜
⬛⬜⬛⬜⬜⬛⬜⬛⬜⬛⬜⬛⬛⬛⬛⬜⬛⬛⬛⬛⬛⬛⬜⬜⬜⬛⬛⬛⬛⬛⬜⬛⬜⬛⬜⬜⬛⬜⬛⬜⬜⬜⬜⬜⬜⬛⬜⬛⬛⬜⬛⬜⬛⬜⬛
⬛⬜⬛⬜⬛⬛⬜⬛⬛⬜⬛⬛⬛⬛⬛⬛⬜⬛⬜⬛⬛⬛⬜⬛⬛⬜⬛⬛⬛⬜⬛⬜⬛⬜⬛⬛⬛⬜⬛⬜⬛⬛⬛⬛⬛⬛⬛⬜⬜⬛⬜⬜⬛⬜⬛
⬛⬛⬛⬛⬜⬛⬜⬜⬜⬛⬜⬜⬛⬛⬛⬛⬜⬛⬜⬛⬛⬛⬛⬛⬛⬜⬛⬛⬛⬛⬜⬛⬛⬜⬛⬛⬛⬛⬛⬜⬜⬜⬜⬛⬛⬛⬛⬛⬛⬜⬛⬛⬛⬜⬜
⬛⬛⬛⬛⬛⬜⬛⬛⬛⬜⬛⬛⬜⬜⬜⬛⬛⬛⬜⬛⬜⬜⬜⬜⬛⬜⬛⬜⬛⬛⬛⬛⬛⬜⬜⬛⬜⬛⬜⬛⬛⬛⬛⬜⬛⬛⬛⬜⬜⬜⬛⬜⬜⬛⬛
⬜⬛⬛⬛⬛⬛⬛⬜⬛⬛⬜⬛⬛⬛⬛⬜⬛⬛⬛⬛⬛⬛⬛⬜⬛⬛⬛⬜⬛⬛⬛⬛⬜⬛⬛⬛⬛⬜⬛⬛⬜⬛⬛⬛⬜⬛⬜⬛⬜⬛⬛⬛⬛⬜⬛
⬛⬜⬛⬛⬜⬛⬜⬜⬜⬜⬜⬛⬜⬛⬛⬛⬜⬜⬛⬜⬜⬜⬛⬜⬛⬜⬛⬜⬛⬜⬛⬛⬜⬜⬛⬜⬛⬜⬛⬜⬜⬛⬜⬜⬜⬛⬛⬛⬛⬛⬛⬜⬛⬜⬛
⬛⬜⬛⬛⬜⬜⬜⬛⬛⬜⬛⬛⬜⬛⬛⬛⬛⬜⬛⬛⬛⬛⬜⬜⬛⬜⬛⬛⬛⬜⬜⬛⬛⬛⬜⬜⬛⬛⬛⬜⬛⬜⬛⬛⬛⬛⬛⬜⬜⬜⬜⬜⬛⬜⬛
⬜⬛⬛⬜⬛⬛⬛⬜⬜⬛⬛⬜⬜⬛⬛⬛⬜⬛⬛⬜⬛⬛⬛⬛⬛⬛⬛⬛⬛⬜⬛⬛⬜⬛⬜⬛⬛⬛⬛⬜⬛⬛⬜⬛⬛⬛⬛⬜⬛⬛⬛⬛⬜⬛⬛
⬛⬜⬜⬜⬜⬛⬛⬜⬛⬛⬛⬛⬛⬛⬛⬜⬛⬜⬛⬜⬛⬛⬛⬜⬛⬛⬜⬛⬛⬜⬛⬜⬛⬜⬛⬛⬜⬛⬛⬛⬜⬛⬛⬛⬛⬛⬛⬜⬜⬛⬜⬜⬜⬛⬛
⬛⬜⬛⬛⬜⬛⬜⬛⬛⬛⬜⬜⬛⬜⬛⬜⬛⬜⬛⬜⬛⬜⬜⬜⬛⬜⬜⬛⬛⬜⬛⬛⬜⬛⬛⬜⬛⬛⬛⬛⬜⬛⬜⬛⬛⬛⬜⬛⬛⬛⬛⬛⬛⬛⬜
⬛⬜⬛⬜⬛⬛⬜⬛⬜⬜⬛⬜⬛⬜⬛⬜⬛⬜⬛⬛⬜⬛⬛⬜⬛⬛⬜⬛⬛⬜⬜⬛⬜⬛⬜⬜⬛⬛⬛⬛⬜⬛⬜⬛⬛⬛⬛⬛⬛⬜⬛⬜⬜⬜⬛
⬛⬛⬜⬛⬜⬛⬜⬛⬛⬛⬜⬜⬛⬜⬛⬜⬜⬛⬛⬛⬛⬜⬛⬛⬜⬜⬛⬜⬛⬛⬛⬛⬜⬛⬛⬛⬛⬛⬛⬛⬜⬛⬛⬛⬜⬜⬜⬜⬜⬛⬜⬛⬛⬛⬛
⬜⬛⬜⬛⬜⬜⬛⬜⬜⬛⬜⬛⬛⬜⬛⬜⬛⬛⬛⬛⬛⬛⬜⬜⬛⬛⬜⬛⬜⬜⬛⬛⬛⬜⬛⬜⬛⬛⬜⬛⬛⬛⬜⬛⬛⬛⬛⬛⬜⬛⬛⬛⬜⬛⬛
⬛⬛⬜⬛⬛⬛⬛⬛⬛⬜⬛⬛⬛⬜⬛⬛⬜⬛⬜⬜⬜⬜⬜⬛⬜⬛⬛⬜⬛⬛⬜⬜⬜⬛⬜⬛⬜⬛⬜⬛⬜⬛⬜⬛⬛⬛⬜⬜⬛⬛⬜⬜⬛⬛⬛
⬛⬛⬛⬛⬜⬛⬜⬜⬛⬜⬛⬜⬛⬜⬛⬜⬛⬛⬜⬛⬛⬛⬛⬛⬛⬛⬛⬜⬛⬛⬛⬛⬛⬛⬜⬛⬜⬛⬜⬛⬜⬜⬛⬛⬛⬜⬛⬛⬛⬛⬛⬛⬜⬜⬜
⬛⬛⬛⬛⬜⬛⬛⬜⬛⬜⬛⬜⬛⬜⬛⬛⬜⬛⬛⬜⬜⬛⬜⬜⬛⬜⬜⬛⬜⬛⬜⬜⬛⬜⬛⬛⬛⬛⬜⬛⬛⬛⬜⬛⬛⬜⬜⬜⬜⬜⬜⬛⬜⬛⬛
⬛⬛⬜⬜⬜⬛⬛⬜⬛⬜⬛⬛⬛⬜⬛⬜⬛⬛⬛⬛⬜⬛⬜⬛⬜⬛⬜⬜⬜⬛⬛⬜⬛⬜⬛⬛⬜⬛⬜⬛⬜⬛⬜⬜⬛⬛⬛⬛⬛⬛⬜⬛⬜⬜⬛
⬛⬜⬛⬛⬛⬛⬜⬛⬛⬛⬛⬛⬛⬜⬛⬜⬛⬜⬜⬛⬜⬛⬜⬛⬜⬛⬛⬛⬛⬜⬜⬛⬛⬛⬜⬜⬛⬛⬜⬛⬜⬛⬛⬛⬛⬜⬜⬜⬛⬛⬜⬛⬜⬛⬛
⬛⬛⬜⬜⬜⬛⬜⬜⬛⬛⬛⬛⬛⬜⬛⬜⬛⬜⬜⬛⬜⬛⬜⬛⬛⬜⬛⬜⬛⬛⬛⬛⬜⬜⬜⬛⬜⬛⬜⬛⬜⬛⬜⬜⬛⬛⬛⬛⬛⬛⬜⬛⬜⬛⬛
⬜⬛⬜⬛⬜⬛⬛⬜⬛⬛⬛⬜⬛⬜⬛⬛⬛⬛⬛⬛⬛⬜⬛⬜⬛⬜⬛⬜⬛⬛⬜⬛⬜⬛⬛⬜⬜⬛⬜⬛⬜⬛⬛⬛⬜⬜⬜⬜⬜⬛⬜⬛⬜⬛⬛
⬛⬛⬜⬛⬜⬛⬛⬜⬜⬛⬛⬛⬜⬛⬛⬛⬛⬛⬜⬜⬜⬜⬛⬛⬜⬛⬜⬛⬜⬜⬜⬛⬛⬜⬜⬛⬛⬛⬛⬛⬜⬛⬛⬜⬛⬛⬛⬛⬛⬜⬛⬛⬛⬛⬛
⬜⬛⬜⬛⬜⬛⬜⬜⬛⬜⬜⬛⬛⬜⬛⬛⬜⬜⬛⬛⬛⬛⬛⬛⬛⬛⬜⬛⬜⬛⬛⬛⬛⬜⬛⬛⬛⬜⬜⬛⬜⬜⬛⬜⬛⬜⬜⬛⬜⬛⬜⬜⬜⬜⬜
⬛⬜⬛⬛⬛⬜⬛⬛⬛⬛⬜⬛⬜⬜⬛⬜⬜⬛⬛⬜⬜⬜⬜⬜⬛⬛⬜⬛⬜⬛⬜⬜⬛⬛⬛⬜⬜⬛⬜⬛⬜⬛⬛⬜⬛⬜⬛⬜⬛⬜⬛⬛⬛⬛⬛
⬛⬜⬛⬛⬛⬛⬜⬜⬜⬛⬜⬛⬛⬜⬛⬛⬜⬛⬜⬛⬜⬛⬛⬛⬜⬛⬛⬜⬜⬛⬜⬛⬛⬛⬜⬜⬛⬛⬛⬜⬛⬛⬜⬛⬛⬛⬛⬛⬜⬛⬛⬛⬛⬛⬛
⬜⬛⬛⬛⬛⬜⬛⬛⬛⬛⬛⬛⬜⬛⬜⬛⬛⬛⬜⬛⬜⬛⬜⬛⬜⬛⬛⬛⬛⬛⬛⬜⬛⬜⬛⬛⬜⬛⬜⬛⬜⬛⬜⬜⬜⬜⬛⬜⬜⬛⬜⬜⬜⬜⬛
⬛⬛⬛⬛⬛⬛⬛⬜⬜⬛⬛⬛⬜⬛⬜⬜⬜⬛⬜⬛⬛⬛⬜⬜⬛⬜⬜⬜⬛⬛⬛⬜⬛⬜⬛⬜⬛⬛⬜⬛⬜⬛⬛⬛⬛⬛⬛⬛⬛⬜⬛⬛⬛⬜⬛
⬜⬜⬜⬜⬜⬜⬜⬛⬜⬛⬛⬛⬜⬛⬛⬛⬜⬛⬜⬛⬜⬜⬛⬛⬛⬛⬛⬜⬛⬛⬜⬛⬛⬜⬛⬜⬛⬛⬜⬜⬛⬜⬛⬜⬛⬜⬛⬜⬛⬛⬜⬜⬛⬜⬛
⬛⬛⬛⬜⬛⬛⬛⬛⬜⬛⬜⬜⬛⬜⬜⬛⬛⬛⬜⬛⬜⬛⬜⬜⬛⬛⬛⬛⬜⬛⬜⬛⬜⬛⬛⬜⬛⬜⬛⬜⬛⬛⬛⬜⬛⬜⬛⬜⬛⬛⬛⬛⬜⬜⬛
⬜⬜⬛⬛⬛⬛⬜⬜⬛⬛⬛⬛⬛⬜⬛⬛⬜⬜⬛⬛⬜⬛⬛⬛⬛⬛⬛⬜⬜⬛⬛⬛⬜⬛⬛⬜⬛⬜⬛⬛⬜⬜⬛⬜⬛⬛⬛⬛⬜⬜⬛⬛⬛⬛⬛
⬛⬜⬛⬛⬛⬜⬜⬛⬛⬛*️⃣⬛⬛⬛⬜⬜⬛⬛⬛⬜⬜⬜⬛⬜⬛⬜⬛⬛⬜⬛⬜⬜⬛⬛⬜⬜⬜⬛⬜⬛⬜⬛⬜⬛⬜⬛⬛⬜⬛⬛⬜⬛⬜⬛⬜
⬛⬜⬛⬛⬛⬛⬛⬛⬛⬛⬛⬛⬜⬛⬛⬛⬛⬛⬛⬛⬛⬜⬛⬛⬜⬜⬛⬛⬛⬛⬛⬜⬛⬜⬛⬛⬜⬛⬜⬛⬜⬛⬜⬛⬛⬜⬜⬛⬜⬜⬜⬜⬛⬛⬛
⬛⬛⬜⬛⬜⬛⬜⬜⬜⬛⬜⬛⬜⬜⬜⬜⬛⬛⬛⬛⬜⬜⬛⬛⬛⬜⬛⬜⬛⬛⬛⬜⬛⬛⬜⬛⬜⬛⬛⬛⬜⬛⬛⬜⬛⬛⬛⬛⬛⬛⬛⬛⬛⬛⬛
⬛⬛⬜⬛⬜⬜⬛⬛⬛⬛⬜⬜⬛⬛⬛⬛⬛⬜⬜⬜⬛⬜⬛⬜⬜⬛⬛⬜⬜⬜⬜⬜⬜⬛⬜⭐⬛⬜⬛⬜⬜⬛⬜⬛⬜⬛⬛⬛⬛⬛⬛⬜⬛⬛⬛
⬜⬜⬛⬛⬛⬛⬛⬜⬛⬜⬛⬛⬛⬜⬜⬛⬛⬛⬛⬛⬛⬜⬜⬛⬜⬛⬜⬛⬛⬛⬛⬛⬛⬛⬜⬜⬛⬜⬛⬜⬛⬛⬜⬜⬛⬛⬜⬛⬛⬜⬛⬛⬜⬜⬛
⬛⬛⬜⬜⬜⬜⬛⬜⬛⬜⬛⬜⬛⬜⬛⬜⬛⬜⬜⬜⬜⬛⬜⬛⬛⬛⬜⬛⬛⬛⬛⬜⬜⬜⬛⬜⬛⬛⬜⬛⬛⬛⬜⬛⬛⬛⬜⬛⬜⬛⬜⬛⬛⬜⬛
⬜⬜⬜⬛⬛⬛⬜⬛⬛⬜⬛⬜⬛⬜⬛⬜⬜⬛⬛⬛⬛⬛⬛⬛⬛⬜⬜⬛⬛⬛⬛⬛⬛⬛⬛⬛⬜⬛⬜⬜⬜⬛⬛⬜⬛⬛⬜⬛⬛⬛⬜⬛⬜⬛⬜
⬛⬛⬛⬛⬜⬜⬜⬛⬜⬛⬛⬜⬛⬜⬛⬛⬛⬜⬛⬛⬛⬛⬛⬛⬜⬛⬛⬛⬛⬛⬛⬜⬜⬜⬜⬛⬛⬛⬛⬛⬛⬜⬜⬜⬛⬛⬛⬛⬜⬜⬛⬜⬛⬜⬛
⬛⬜⬜⬛⬛⬛⬛⬜⬜⬛⬜⬛⬛⬜⬛⬛⬛⬜⬛⬛⬛⬜⬛⬛⬜⬛⬜⬜⬛⬜⬛⬛⬛⬛⬛⬜⬜⬜⬛⬛⬛⬛⬛⬛⬜⬜⬛⬜⬛⬛⬛⬜⬛⬛⬛
⬛⬜⬛⬜⬛⬜⬛⬜⬛⬛⬜⬜⬜⬛⬛⬛⬛⬜⬜⬛⬛⬜⬜⬜⬛⬛⬜⬜⬛⬜⬜⬛⬜⬜⬜⬛⬛⬛⬜⬛⬛⬛⬛⬜⬛⬛⬜⬜⬜⬜⬛⬜⬛⬛⬛
⬜⬛⬛⬜⬛⬛⬜⬛⬜⬛⬛⬛⬛⬜⬛⬛⬛⬛⬛⬛⬛⬜⬛⬛⬜⬛⬛⬛⬛⬛⬛⬛⬛⬛⬛⬛⬜⬜⬛⬛⬛⬛⬛⬛⬛⬛⬜⬛⬛⬜⬛⬛⬜⬛⬛
